EN	FR	DE	P9	P2	P29	
create	items			Q10	Q15	
			name monoLingualText 'fr' - label	instance of - human	occupation - author	
ABBES DE CABREROLES, d’	ABBES DE CABREROLES, d’	ABBES DE CABREROLES, d’	ABBES DE CABREROLES, d’			
ACHILLES TATIUS	ACHILLES TATIUS	ACHILLES TATIUS	ACHILLES TATIUS			
AIKIN, John	AIKIN, John	AIKIN, John	AIKIN, John			
AILÉ	AILÉ	AILÉ	AILÉ			
ALBERT, mademoiselle d’	ALBERT, mademoiselle d’	ALBERT, mademoiselle d’	ALBERT, mademoiselle d’			
ALCIPHRON	ALCIPHRON	ALCIPHRON	ALCIPHRON			
ALEMAN, Mateo	ALEMAN, Mateo	ALEMAN, Mateo	ALEMAN, Mateo			
ALGAROTTI, comte Francesco	ALGAROTTI, comte Francesco	ALGAROTTI, comte Francesco	ALGAROTTI, comte Francesco			
ALI TCHELEBI IBN SALIH	ALI TCHELEBI IBN SALIH	ALI TCHELEBI IBN SALIH	ALI TCHELEBI IBN SALIH			
ALLINGTON, Maria d’	ALLINGTON, Maria d’	ALLINGTON, Maria d’	ALLINGTON, Maria d’			
ANDRIEUX, François-Guillaume-Jean-Stanislas	ANDRIEUX, François-Guillaume-Jean-Stanislas	ANDRIEUX, François-Guillaume-Jean-Stanislas	ANDRIEUX, François-Guillaume-Jean-Stanislas			
ANDRÉ, Jean-François	ANDRÉ, Jean-François	ANDRÉ, Jean-François	ANDRÉ, Jean-François			
ANSART, dom André-Joseph	ANSART, dom André-Joseph	ANSART, dom André-Joseph	ANSART, dom André-Joseph			
ANTOINETTE WALPURGIS DE BAVIÈRE, princesse de Pologne	ANTOINETTE WALPURGIS DE BAVIÈRE, princesse de Pologne	ANTOINETTE WALPURGIS DE BAVIÈRE, princesse de Pologne	ANTOINETTE WALPURGIS DE BAVIÈRE, princesse de Pologne			
ANTRAIGUES, madame d’	ANTRAIGUES, madame d’	ANTRAIGUES, madame d’	ANTRAIGUES, madame d’			
APOLLONIUS DE RHODES	APOLLONIUS DE RHODES	APOLLONIUS DE RHODES	APOLLONIUS DE RHODES			
APULÉE	APULÉE	APULÉE	APULÉE			
ARBLAY, Frances Burney, madame d’	ARBLAY, Frances Burney, madame d’	ARBLAY, Frances Burney, madame d’	ARBLAY, Frances Burney, madame d’			
ARBUTHNOT, John	ARBUTHNOT, John	ARBUTHNOT, John	ARBUTHNOT, John			
ARCQ, Philippe-Auguste de Sainte-Foix, chevalier d’	ARCQ, Philippe-Auguste de Sainte-Foix, chevalier d’	ARCQ, Philippe-Auguste de Sainte-Foix, chevalier d’	ARCQ, Philippe-Auguste de Sainte-Foix, chevalier d’			
ARDÈNE, Esp.-J. Rome d’	ARDÈNE, Esp.-J. Rome d’	ARDÈNE, Esp.-J. Rome d’	ARDÈNE, Esp.-J. Rome d’			
ARETINO, Pietro Bacci, dit	ARETINO, Pietro Bacci, dit	ARETINO, Pietro Bacci, dit	ARETINO, Pietro Bacci, dit			
ARGENS, Jean-Baptiste de Boyer, marquis d’	ARGENS, Jean-Baptiste de Boyer, marquis d’	ARGENS, Jean-Baptiste de Boyer, marquis d’	ARGENS, Jean-Baptiste de Boyer, marquis d’			
ARIOSTO, Lodovico	ARIOSTO, Lodovico	ARIOSTO, Lodovico	ARIOSTO, Lodovico			
ARISTÉNÈTE	ARISTÉNÈTE	ARISTÉNÈTE	ARISTÉNÈTE			
ARNAUD, François-Thomas-Marie de Baculard d’	ARNAUD, François-Thomas-Marie de Baculard d’	ARNAUD, François-Thomas-Marie de Baculard d’	ARNAUD, François-Thomas-Marie de Baculard d’			
ARTAUD, Jean-Baptiste	ARTAUD, Jean-Baptiste	ARTAUD, Jean-Baptiste	ARTAUD, Jean-Baptiste			
ARTOIS, d’ (curé de Moléans)	ARTOIS, d’ (curé de Moléans)	ARTOIS, d’ (curé de Moléans)	ARTOIS, d’ (curé de Moléans)			
AUNEUIL, Louise de Bossigny, comtesse d’	AUNEUIL, Louise de Bossigny, comtesse d’	AUNEUIL, Louise de Bossigny, comtesse d’	AUNEUIL, Louise de Bossigny, comtesse d’			
BAGE, Robert	BAGE, Robert	BAGE, Robert	BAGE, Robert			
BAHRDT, Carl Friedrich	BAHRDT, Carl Friedrich	BAHRDT, Carl Friedrich	BAHRDT, Carl Friedrich			
BALTHAZARD, abbé	BALTHAZARD, abbé	BALTHAZARD, abbé	BALTHAZARD, abbé			
BARBA, Jean-Nicolas	BARBA, Jean-Nicolas	BARBA, Jean-Nicolas	BARBA, Jean-Nicolas			
BARBAULD, Anna Letitia Aikin, Mrs	BARBAULD, Anna Letitia Aikin, Mrs	BARBAULD, Anna Letitia Aikin, Mrs	BARBAULD, Anna Letitia Aikin, Mrs			
BARBAULT-ROYER, P.-F.	BARBAULT-ROYER, P.-F.	BARBAULT-ROYER, P.-F.	BARBAULT-ROYER, P.-F.			
BARBEU DU BOURG, Jacques	BARBEU DU BOURG, Jacques	BARBEU DU BOURG, Jacques	BARBEU DU BOURG, Jacques			
BARBÉ-MARBOIS, François, marquis de	BARBÉ-MARBOIS, François, marquis de	BARBÉ-MARBOIS, François, marquis de	BARBÉ-MARBOIS, François, marquis de			
BARCLAY, John	BARCLAY, John	BARCLAY, John	BARCLAY, John			
BARDOU, Jean	BARDOU, Jean	BARDOU, Jean	BARDOU, Jean			
BARET, Paul	BARET, Paul	BARET, Paul	BARET, Paul			
BARTHE, Nicolas-Thomas	BARTHE, Nicolas-Thomas	BARTHE, Nicolas-Thomas	BARTHE, Nicolas-Thomas			
BARTHEZ (avocat)	BARTHEZ (avocat)	BARTHEZ (avocat)	BARTHEZ (avocat)			
BARTHÉLEMY, abbé Jean-Jacques	BARTHÉLEMY, abbé Jean-Jacques	BARTHÉLEMY, abbé Jean-Jacques	BARTHÉLEMY, abbé Jean-Jacques			
BARTHÉLEMY, abbé Louis	BARTHÉLEMY, abbé Louis	BARTHÉLEMY, abbé Louis	BARTHÉLEMY, abbé Louis			
BASEDOW, Johann Bernhard	BASEDOW, Johann Bernhard	BASEDOW, Johann Bernhard	BASEDOW, Johann Bernhard			
BASTIDE, Jean-François de	BASTIDE, Jean-François de	BASTIDE, Jean-François de	BASTIDE, Jean-François de			
BASTON, abbé Guillaume-André-René	BASTON, abbé Guillaume-André-René	BASTON, abbé Guillaume-André-René	BASTON, abbé Guillaume-André-René			
BAUDOUIN DE GUÉMADEUC	BAUDOUIN DE GUÉMADEUC	BAUDOUIN DE GUÉMADEUC	BAUDOUIN DE GUÉMADEUC			
BAUDRAND, le père Barthélemi	BAUDRAND, le père Barthélemi	BAUDRAND, le père Barthélemi	BAUDRAND, le père Barthélemi			
BAUGIN, Pierre-François-Cantien	BAUGIN, Pierre-François-Cantien	BAUGIN, Pierre-François-Cantien	BAUGIN, Pierre-François-Cantien			
BEAUCLAIR, Pierre-Louis de	BEAUCLAIR, Pierre-Louis de	BEAUCLAIR, Pierre-Louis de	BEAUCLAIR, Pierre-Louis de			
BEAUFORT D’AUBERVAL, Alphonse-Aimé	BEAUFORT D’AUBERVAL, Alphonse-Aimé	BEAUFORT D’AUBERVAL, Alphonse-Aimé	BEAUFORT D’AUBERVAL, Alphonse-Aimé			
BEAUFORT D’HAUTPOUL, comtesse Joséphine, née de Coutances	BEAUFORT D’HAUTPOUL, comtesse Joséphine, née de Coutances	BEAUFORT D’HAUTPOUL, comtesse Joséphine, née de Coutances	BEAUFORT D’HAUTPOUL, comtesse Joséphine, née de Coutances			
BEAUHARNAIS, Fanny de	BEAUHARNAIS, Fanny de	BEAUHARNAIS, Fanny de	BEAUHARNAIS, Fanny de			
BEAUMANOIR, de	BEAUMANOIR, de	BEAUMANOIR, de	BEAUMANOIR, de			
BEAUMER, madame de	BEAUMER, madame de	BEAUMER, madame de	BEAUMER, madame de			
BEAUNOIR, Alexandre-Louis-Bertrand Robineau, dit de	BEAUNOIR, Alexandre-Louis-Bertrand Robineau, dit de	BEAUNOIR, Alexandre-Louis-Bertrand Robineau, dit de	BEAUNOIR, Alexandre-Louis-Bertrand Robineau, dit de			
BEAURIEU, Gaspard Guillard de	BEAURIEU, Gaspard Guillard de	BEAURIEU, Gaspard Guillard de	BEAURIEU, Gaspard Guillard de			
BECCARY, madame	BECCARY, madame	BECCARY, madame	BECCARY, madame			
BECKFORD, William	BECKFORD, William	BECKFORD, William	BECKFORD, William			
BEHN, Mrs Aphra	BEHN, Mrs Aphra	BEHN, Mrs Aphra	BEHN, Mrs Aphra			
BELIARD, François	BELIARD, François	BELIARD, François	BELIARD, François			
BELLIN DE LA LIBORLIÈRE, Louis-François-Marie	BELLIN DE LA LIBORLIÈRE, Louis-François-Marie	BELLIN DE LA LIBORLIÈRE, Louis-François-Marie	BELLIN DE LA LIBORLIÈRE, Louis-François-Marie			
BENNETT, Agnes Maria	BENNETT, Agnes Maria	BENNETT, Agnes Maria	BENNETT, Agnes Maria			
BENOIST, Françoise-Albine Puzin de La Martinière, madame	BENOIST, Françoise-Albine Puzin de La Martinière, madame	BENOIST, Françoise-Albine Puzin de La Martinière, madame	BENOIST, Françoise-Albine Puzin de La Martinière, madame			
BENOIST-LAMOTHE, François-Nicolas	BENOIST-LAMOTHE, François-Nicolas	BENOIST-LAMOTHE, François-Nicolas	BENOIST-LAMOTHE, François-Nicolas			
BENOUVILLE, madame de	BENOUVILLE, madame de	BENOUVILLE, madame de	BENOUVILLE, madame de			
BERINGTON, Simon	BERINGTON, Simon	BERINGTON, Simon	BERINGTON, Simon			
BERKELEY, George Monck	BERKELEY, George Monck	BERKELEY, George Monck	BERKELEY, George Monck			
BERNARD, François	BERNARD, François	BERNARD, François	BERNARD, François			
BERNARD, Pierre-Joseph, dit Gentil-Bernard	BERNARD, Pierre-Joseph, dit Gentil-Bernard	BERNARD, Pierre-Joseph, dit Gentil-Bernard	BERNARD, Pierre-Joseph, dit Gentil-Bernard			
BERQUIN, Arnaud	BERQUIN, Arnaud	BERQUIN, Arnaud	BERQUIN, Arnaud			
BERTHEVIN, J.-J.-G.	BERTHEVIN, J.-J.-G.	BERTHEVIN, J.-J.-G.	BERTHEVIN, J.-J.-G.			
BERTIN, le chevalier Antoine de	BERTIN, le chevalier Antoine de	BERTIN, le chevalier Antoine de	BERTIN, le chevalier Antoine de			
BERTRAND (de Montpellier)	BERTRAND (de Montpellier)	BERTRAND (de Montpellier)	BERTRAND (de Montpellier)			
BERTRAND, Elie	BERTRAND, Elie	BERTRAND, Elie	BERTRAND, Elie			
BETTE D’ETTIENVILLE, Jean-Charles-Vincent de	BETTE D’ETTIENVILLE, Jean-Charles-Vincent de	BETTE D’ETTIENVILLE, Jean-Charles-Vincent de	BETTE D’ETTIENVILLE, Jean-Charles-Vincent de			
BEUVIUS, Adam	BEUVIUS, Adam	BEUVIUS, Adam	BEUVIUS, Adam			
BICKNELL, Alexander	BICKNELL, Alexander	BICKNELL, Alexander	BICKNELL, Alexander			
BIGNON, abbé Jean-Paul	BIGNON, abbé Jean-Paul	BIGNON, abbé Jean-Paul	BIGNON, abbé Jean-Paul			
BILDERBECK, baron Ludwig Benedict Franz von	BILDERBECK, baron Ludwig Benedict Franz von	BILDERBECK, baron Ludwig Benedict Franz von	BILDERBECK, baron Ludwig Benedict Franz von			
BILLARDON DE SAUVIGNY, Louis-Edme	BILLARDON DE SAUVIGNY, Louis-Edme	BILLARDON DE SAUVIGNY, Louis-Edme	BILLARDON DE SAUVIGNY, Louis-Edme			
BISSY, Claude de Thyard, comte de	BISSY, Claude de Thyard, comte de	BISSY, Claude de Thyard, comte de	BISSY, Claude de Thyard, comte de			
BITAUBÉ, Paul-Jérémie	BITAUBÉ, Paul-Jérémie	BITAUBÉ, Paul-Jérémie	BITAUBÉ, Paul-Jérémie			
BIZET	BIZET	BIZET	BIZET			
BIÈVRE, François-Georges Maréchal, marquis de	BIÈVRE, François-Georges Maréchal, marquis de	BIÈVRE, François-Georges Maréchal, marquis de	BIÈVRE, François-Georges Maréchal, marquis de			
BLANCHARD, Pierre	BLANCHARD, Pierre	BLANCHARD, Pierre	BLANCHARD, Pierre			
BLANCHET, abbé François	BLANCHET, abbé François	BLANCHET, abbé François	BLANCHET, abbé François			
BLANES, Henri-Barthélemy	BLANES, Henri-Barthélemy	BLANES, Henri-Barthélemy	BLANES, Henri-Barthélemy			
BLONDEAU, Etienne-Nicolas	BLONDEAU, Etienne-Nicolas	BLONDEAU, Etienne-Nicolas	BLONDEAU, Etienne-Nicolas			
BLONDEL, Jacques-François de	BLONDEL, Jacques-François de	BLONDEL, Jacques-François de	BLONDEL, Jacques-François de			
BLOWER, Elizabeth	BLOWER, Elizabeth	BLOWER, Elizabeth	BLOWER, Elizabeth			
BOCCACCIO, Giovanni	BOCCACCIO, Giovanni	BOCCACCIO, Giovanni	BOCCACCIO, Giovanni			
BOCQUILLON	BOCQUILLON	BOCQUILLON	BOCQUILLON			
BODARD DE TEZAY, Nicolas-Marie-Félix	BODARD DE TEZAY, Nicolas-Marie-Félix	BODARD DE TEZAY, Nicolas-Marie-Félix	BODARD DE TEZAY, Nicolas-Marie-Félix			
BODIN DE BOISMORTIER, Suzanne	BODIN DE BOISMORTIER, Suzanne	BODIN DE BOISMORTIER, Suzanne	BODIN DE BOISMORTIER, Suzanne			
BOESNIER	BOESNIER	BOESNIER	BOESNIER			
BOIARDO, Matteo Maria	BOIARDO, Matteo Maria	BOIARDO, Matteo Maria	BOIARDO, Matteo Maria			
BOIELDIEU, Marie-Jacques-Amand	BOIELDIEU, Marie-Jacques-Amand	BOIELDIEU, Marie-Jacques-Amand	BOIELDIEU, Marie-Jacques-Amand			
BOISGELIN DE KERDU, chevalier Pierre-Marie-Louis de	BOISGELIN DE KERDU, chevalier Pierre-Marie-Louis de	BOISGELIN DE KERDU, chevalier Pierre-Marie-Louis de	BOISGELIN DE KERDU, chevalier Pierre-Marie-Louis de			
BOISGIRON, madame de	BOISGIRON, madame de	BOISGIRON, madame de	BOISGIRON, madame de			
BOISMINON (BOISMIRON)	BOISMINON (BOISMIRON)	BOISMINON (BOISMIRON)	BOISMINON (BOISMIRON)			
BOISSY, Louis de	BOISSY, Louis de	BOISSY, Louis de	BOISSY, Louis de			
BONAPARTE, Joseph-Napoléon, roi d’Espagne	BONAPARTE, Joseph-Napoléon, roi d’Espagne	BONAPARTE, Joseph-Napoléon, roi d’Espagne	BONAPARTE, Joseph-Napoléon, roi d’Espagne			
BONAPARTE, Lucien, prince de	BONAPARTE, Lucien, prince de	BONAPARTE, Lucien, prince de	BONAPARTE, Lucien, prince de			
BONHOTE, Mrs Elizabeth	BONHOTE, Mrs Elizabeth	BONHOTE, Mrs Elizabeth	BONHOTE, Mrs Elizabeth			
BOOSER, madame	BOOSER, madame	BOOSER, madame	BOOSER, madame			
BORDE, Charles	BORDE, Charles	BORDE, Charles	BORDE, Charles			
BORDELON, Laurent	BORDELON, Laurent	BORDELON, Laurent	BORDELON, Laurent			
BOUDIER DE VILLEMERT, Pierre-Joseph	BOUDIER DE VILLEMERT, Pierre-Joseph	BOUDIER DE VILLEMERT, Pierre-Joseph	BOUDIER DE VILLEMERT, Pierre-Joseph			
BOUFFLERS, Stanislas-Jean, marquis de	BOUFFLERS, Stanislas-Jean, marquis de	BOUFFLERS, Stanislas-Jean, marquis de	BOUFFLERS, Stanislas-Jean, marquis de			
BOULARD, Martin-Sylvestre	BOULARD, Martin-Sylvestre	BOULARD, Martin-Sylvestre	BOULARD, Martin-Sylvestre			
BOULLAULT, Mathurin-J.	BOULLAULT, Mathurin-J.	BOULLAULT, Mathurin-J.	BOULLAULT, Mathurin-J.			
BOUREAU-DESLANDES, André-François	BOUREAU-DESLANDES, André-François	BOUREAU-DESLANDES, André-François	BOUREAU-DESLANDES, André-François			
BOURGOING, le baron Jean-François de	BOURGOING, le baron Jean-François de	BOURGOING, le baron Jean-François de	BOURGOING, le baron Jean-François de			
BOURLIN, Antoine-Jean	BOURLIN, Antoine-Jean	BOURLIN, Antoine-Jean	BOURLIN, Antoine-Jean			
BOUTERWEK, Friedrich	BOUTERWEK, Friedrich	BOUTERWEK, Friedrich	BOUTERWEK, Friedrich			
BOUTET DE MONVEL, Jacques-Marie	BOUTET DE MONVEL, Jacques-Marie	BOUTET DE MONVEL, Jacques-Marie	BOUTET DE MONVEL, Jacques-Marie			
BRANCAS-VILLENEUVE, André-François, abbé de	BRANCAS-VILLENEUVE, André-François, abbé de	BRANCAS-VILLENEUVE, André-François, abbé de	BRANCAS-VILLENEUVE, André-François, abbé de			
BRANDON, Isaac	BRANDON, Isaac	BRANDON, Isaac	BRANDON, Isaac			
BRAYER DE SAINT-LÉON, Louise-Marguerite-Jeanne-Madeleine	BRAYER DE SAINT-LÉON, Louise-Marguerite-Jeanne-Madeleine	BRAYER DE SAINT-LÉON, Louise-Marguerite-Jeanne-Madeleine	BRAYER DE SAINT-LÉON, Louise-Marguerite-Jeanne-Madeleine			
BRET, Antoine	BRET, Antoine	BRET, Antoine	BRET, Antoine			
BRICAIRE DE LA DIXMERIE, Nicolas	BRICAIRE DE LA DIXMERIE, Nicolas	BRICAIRE DE LA DIXMERIE, Nicolas	BRICAIRE DE LA DIXMERIE, Nicolas			
BRIDEL, Jean-Louis	BRIDEL, Jean-Louis	BRIDEL, Jean-Louis	BRIDEL, Jean-Louis			
BRIEL, J.-H.-D.	BRIEL, J.-H.-D.	BRIEL, J.-H.-D.	BRIEL, J.-H.-D.			
BRISSOT DE WARVILLE, Jacques-Pierre	BRISSOT DE WARVILLE, Jacques-Pierre	BRISSOT DE WARVILLE, Jacques-Pierre	BRISSOT DE WARVILLE, Jacques-Pierre			
BRIZARD, abbé Gabriel	BRIZARD, abbé Gabriel	BRIZARD, abbé Gabriel	BRIZARD, abbé Gabriel			
BROHON, Jacqueline-Aimée	BROHON, Jacqueline-Aimée	BROHON, Jacqueline-Aimée	BROHON, Jacqueline-Aimée			
BRONNER, Franz Xavier	BRONNER, Franz Xavier	BRONNER, Franz Xavier	BRONNER, Franz Xavier			
BROOKE, Frances Moore	BROOKE, Frances Moore	BROOKE, Frances Moore	BROOKE, Frances Moore			
BROOKE, Henry	BROOKE, Henry	BROOKE, Henry	BROOKE, Henry			
BRUGUIÈRE, J.-T. (du Gard)	BRUGUIÈRE, J.-T. (du Gard)	BRUGUIÈRE, J.-T. (du Gard)	BRUGUIÈRE, J.-T. (du Gard)			
BRUIX, de (de Bayonne)	BRUIX, de (de Bayonne)	BRUIX, de (de Bayonne)	BRUIX, de (de Bayonne)			
BRUMENT	BRUMENT	BRUMENT	BRUMENT			
BRUNET DE BAINES	BRUNET DE BAINES	BRUNET DE BAINES	BRUNET DE BAINES			
BRUNO, Louis de	BRUNO, Louis de	BRUNO, Louis de	BRUNO, Louis de			
BRUSSEL, Pierre	BRUSSEL, Pierre	BRUSSEL, Pierre	BRUSSEL, Pierre			
BRUTÉ DE LOIRELLE, abbé	BRUTÉ DE LOIRELLE, abbé	BRUTÉ DE LOIRELLE, abbé	BRUTÉ DE LOIRELLE, abbé			
BURKE, Mrs Ann	BURKE, Mrs Ann	BURKE, Mrs Ann	BURKE, Mrs Ann			
BURKE, Mrs W.	BURKE, Mrs W.	BURKE, Mrs W.	BURKE, Mrs W.			
BURTON, Mrs	BURTON, Mrs	BURTON, Mrs	BURTON, Mrs			
BUTEL-DUMONT, Georges-Marie	BUTEL-DUMONT, Georges-Marie	BUTEL-DUMONT, Georges-Marie	BUTEL-DUMONT, Georges-Marie			
BUTINI, Jean-François	BUTINI, Jean-François	BUTINI, Jean-François	BUTINI, Jean-François			
BÉDIGIS, François-Nicolas	BÉDIGIS, François-Nicolas	BÉDIGIS, François-Nicolas	BÉDIGIS, François-Nicolas			
BÉRENGER, Jean-Pierre	BÉRENGER, Jean-Pierre	BÉRENGER, Jean-Pierre	BÉRENGER, Jean-Pierre			
BÉRENGER, Laurent-Pierre	BÉRENGER, Laurent-Pierre	BÉRENGER, Laurent-Pierre	BÉRENGER, Laurent-Pierre			
BÉTHISY DE MÉZIÈRES, Eugène-Eléonore de	BÉTHISY DE MÉZIÈRES, Eugène-Eléonore de	BÉTHISY DE MÉZIÈRES, Eugène-Eléonore de	BÉTHISY DE MÉZIÈRES, Eugène-Eléonore de			
BÊLIARD, François	BÊLIARD, François	BÊLIARD, François	BÊLIARD, François			
CACOUAULT DE LA MIMARDIÈRE, mademoiselle	CACOUAULT DE LA MIMARDIÈRE, mademoiselle	CACOUAULT DE LA MIMARDIÈRE, mademoiselle	CACOUAULT DE LA MIMARDIÈRE, mademoiselle			
CADET DE GASSICOURT, Charles-Louis	CADET DE GASSICOURT, Charles-Louis	CADET DE GASSICOURT, Charles-Louis	CADET DE GASSICOURT, Charles-Louis			
CAGNIARD	CAGNIARD	CAGNIARD	CAGNIARD			
CAILHAVA DE L’ESTENDOUX, Jean-François	CAILHAVA DE L’ESTENDOUX, Jean-François	CAILHAVA DE L’ESTENDOUX, Jean-François	CAILHAVA DE L’ESTENDOUX, Jean-François			
CAILLEAU, André-Charles	CAILLEAU, André-Charles	CAILLEAU, André-Charles	CAILLEAU, André-Charles			
CALVEL, abbé Etienne	CALVEL, abbé Etienne	CALVEL, abbé Etienne	CALVEL, abbé Etienne			
CAMBRY, Jacques	CAMBRY, Jacques	CAMBRY, Jacques	CAMBRY, Jacques			
CAMPAN, Dominique	CAMPAN, Dominique	CAMPAN, Dominique	CAMPAN, Dominique			
CAMPE, Joachim	CAMPE, Joachim	CAMPE, Joachim	CAMPE, Joachim			
CAMPENON, Vincent	CAMPENON, Vincent	CAMPENON, Vincent	CAMPENON, Vincent			
CAMUS-DARAS, Nicolas-René	CAMUS-DARAS, Nicolas-René	CAMUS-DARAS, Nicolas-René	CAMUS-DARAS, Nicolas-René			
CAMÔES, Luis de	CAMÔES, Luis de	CAMÔES, Luis de	CAMÔES, Luis de			
CARACCIOLI, Louis-Antoine, marquis de	CARACCIOLI, Louis-Antoine, marquis de	CARACCIOLI, Louis-Antoine, marquis de	CARACCIOLI, Louis-Antoine, marquis de			
CARMONTELLE, Louis Carrogis, dit	CARMONTELLE, Louis Carrogis, dit	CARMONTELLE, Louis Carrogis, dit	CARMONTELLE, Louis Carrogis, dit			
CARNÉ, de	CARNÉ, de	CARNÉ, de	CARNÉ, de			
CARRA, Jean-Louis	CARRA, Jean-Louis	CARRA, Jean-Louis	CARRA, Jean-Louis			
CARTWRIGHT, Mrs H.	CARTWRIGHT, Mrs H.	CARTWRIGHT, Mrs H.	CARTWRIGHT, Mrs H.			
CASANOVA, Giacomo, dit	CASANOVA, Giacomo, dit	CASANOVA, Giacomo, dit	CASANOVA, Giacomo, dit			
CASTELNAU, marquis Gabriel de	CASTELNAU, marquis Gabriel de	CASTELNAU, marquis Gabriel de	CASTELNAU, marquis Gabriel de			
CASTILHON, Jean	CASTILHON, Jean	CASTILHON, Jean	CASTILHON, Jean			
CASTILHON, Jean-Louis	CASTILHON, Jean-Louis	CASTILHON, Jean-Louis	CASTILHON, Jean-Louis			
CATHERINE II, impératrice de Russie	CATHERINE II, impératrice de Russie	CATHERINE II, impératrice de Russie	CATHERINE II, impératrice de Russie			
CAVENDISH, Georgiana, duchesse de Devonshire	CAVENDISH, Georgiana, duchesse de Devonshire	CAVENDISH, Georgiana, duchesse de Devonshire	CAVENDISH, Georgiana, duchesse de Devonshire			
CAYLUS, Anne-Gaude-Philippe de	CAYLUS, Anne-Gaude-Philippe de	CAYLUS, Anne-Gaude-Philippe de	CAYLUS, Anne-Gaude-Philippe de			
CAZALET, Nicolas	CAZALET, Nicolas	CAZALET, Nicolas	CAZALET, Nicolas			
CAZENOVE D’ARLENS, Constance de	CAZENOVE D’ARLENS, Constance de	CAZENOVE D’ARLENS, Constance de	CAZENOVE D’ARLENS, Constance de			
CAZOTTE, Jacques	CAZOTTE, Jacques	CAZOTTE, Jacques	CAZOTTE, Jacques			
CERFVOL, de	CERFVOL, de	CERFVOL, de	CERFVOL, de			
CERVANTES SAAVEDRA, Miguel de	CERVANTES SAAVEDRA, Miguel de	CERVANTES SAAVEDRA, Miguel de	CERVANTES SAAVEDRA, Miguel de			
CESAROTTI, abbé Melchior	CESAROTTI, abbé Melchior	CESAROTTI, abbé Melchior	CESAROTTI, abbé Melchior			
CHAINEL, Philippe-Antoine	CHAINEL, Philippe-Antoine	CHAINEL, Philippe-Antoine	CHAINEL, Philippe-Antoine			
CHAISNEAU, abbé Charles	CHAISNEAU, abbé Charles	CHAISNEAU, abbé Charles	CHAISNEAU, abbé Charles			
CHAMBERT, Pierre	CHAMBERT, Pierre	CHAMBERT, Pierre	CHAMBERT, Pierre			
CHAMPAGNY, Charles de Nompère, chevalier de	CHAMPAGNY, Charles de Nompère, chevalier de	CHAMPAGNY, Charles de Nompère, chevalier de	CHAMPAGNY, Charles de Nompère, chevalier de			
CHAMPIGNY	CHAMPIGNY	CHAMPIGNY	CHAMPIGNY			
CHAMPIGNY, colonel chevalier Jean de	CHAMPIGNY, colonel chevalier Jean de	CHAMPIGNY, colonel chevalier Jean de	CHAMPIGNY, colonel chevalier Jean de			
CHAMPION DE NILON, le père Charles-François	CHAMPION DE NILON, le père Charles-François	CHAMPION DE NILON, le père Charles-François	CHAMPION DE NILON, le père Charles-François			
CHARITON D’APHRODISIAS	CHARITON D’APHRODISIAS	CHARITON D’APHRODISIAS	CHARITON D’APHRODISIAS			
CHARLTON, Mary	CHARLTON, Mary	CHARLTON, Mary	CHARLTON, Mary			
CHARPENTIER, Louis	CHARPENTIER, Louis	CHARPENTIER, Louis	CHARPENTIER, Louis			
CHARRIÉRE, Isabelle-Agnès-Elisabeth van Tuyll van Serooskerken van Zuylen, dame de	CHARRIÉRE, Isabelle-Agnès-Elisabeth van Tuyll van Serooskerken van Zuylen, dame de	CHARRIÉRE, Isabelle-Agnès-Elisabeth van Tuyll van Serooskerken van Zuylen, dame de	CHARRIÉRE, Isabelle-Agnès-Elisabeth van Tuyll van Serooskerken van Zuylen, dame de			
CHAUDON DE LA MEDE	CHAUDON DE LA MEDE	CHAUDON DE LA MEDE	CHAUDON DE LA MEDE			
CHAUSSARD, Pierre-Jean-Baptiste, dit Publicola	CHAUSSARD, Pierre-Jean-Baptiste, dit Publicola	CHAUSSARD, Pierre-Jean-Baptiste, dit Publicola	CHAUSSARD, Pierre-Jean-Baptiste, dit Publicola			
CHAUSSIER, Hector	CHAUSSIER, Hector	CHAUSSIER, Hector	CHAUSSIER, Hector			
CHEVRIER, François-Antoine	CHEVRIER, François-Antoine	CHEVRIER, François-Antoine	CHEVRIER, François-Antoine			
CHIARI, Pietro	CHIARI, Pietro	CHIARI, Pietro	CHIARI, Pietro			
CHICANEAU DE NEUVILLE, Didier-Pierre	CHICANEAU DE NEUVILLE, Didier-Pierre	CHICANEAU DE NEUVILLE, Didier-Pierre	CHICANEAU DE NEUVILLE, Didier-Pierre			
CHINIAC DE LA BASTIDE DU CLAUX, Pierre de	CHINIAC DE LA BASTIDE DU CLAUX, Pierre de	CHINIAC DE LA BASTIDE DU CLAUX, Pierre de	CHINIAC DE LA BASTIDE DU CLAUX, Pierre de			
CHINIAC DE LA BASTIDE, Jean-Baptiste de	CHINIAC DE LA BASTIDE, Jean-Baptiste de	CHINIAC DE LA BASTIDE, Jean-Baptiste de	CHINIAC DE LA BASTIDE, Jean-Baptiste de			
CHODERLOS DE LACLOS, Pierre-Ambroise-François	CHODERLOS DE LACLOS, Pierre-Ambroise-François	CHODERLOS DE LACLOS, Pierre-Ambroise-François	CHODERLOS DE LACLOS, Pierre-Ambroise-François			
CHOISEUL-MEUSE, comtesse Félicité de	CHOISEUL-MEUSE, comtesse Félicité de	CHOISEUL-MEUSE, comtesse Félicité de	CHOISEUL-MEUSE, comtesse Félicité de			
CHOMEL, Antoine-Angélique	CHOMEL, Antoine-Angélique	CHOMEL, Antoine-Angélique	CHOMEL, Antoine-Angélique			
CHÉRENSI, B. Frere de	CHÉRENSI, B. Frere de	CHÉRENSI, B. Frere de	CHÉRENSI, B. Frere de			
CILED, F.-A.	CILED, F.-A.	CILED, F.-A.	CILED, F.-A.			
CLELAND, John	CLELAND, John	CLELAND, John	CLELAND, John			
COIFFIER DE MORET, Simon	COIFFIER DE MORET, Simon	COIFFIER DE MORET, Simon	COIFFIER DE MORET, Simon			
COIFFIER DE VERSEUX, le baron Henri-Louis	COIFFIER DE VERSEUX, le baron Henri-Louis	COIFFIER DE VERSEUX, le baron Henri-Louis	COIFFIER DE VERSEUX, le baron Henri-Louis			
COINTREAU	COINTREAU	COINTREAU	COINTREAU			
COLLEVILLE, Anne-Hyacinthe de Saint-Léger, dame de	COLLEVILLE, Anne-Hyacinthe de Saint-Léger, dame de	COLLEVILLE, Anne-Hyacinthe de Saint-Léger, dame de	COLLEVILLE, Anne-Hyacinthe de Saint-Léger, dame de			
COLLEVILLE, Charles-Denis	COLLEVILLE, Charles-Denis	COLLEVILLE, Charles-Denis	COLLEVILLE, Charles-Denis			
COMBE, William	COMBE, William	COMBE, William	COMBE, William			
COMPAGNONI, Giuseppe	COMPAGNONI, Giuseppe	COMPAGNONI, Giuseppe	COMPAGNONI, Giuseppe			
COMPAN, Charles, abbé	COMPAN, Charles, abbé	COMPAN, Charles, abbé	COMPAN, Charles, abbé			
CONDREN-SUSANNE, A.-C.-L.	CONDREN-SUSANNE, A.-C.-L.	CONDREN-SUSANNE, A.-C.-L.	CONDREN-SUSANNE, A.-C.-L.			
CONSTANT DE REBECQUE, Samuel de	CONSTANT DE REBECQUE, Samuel de	CONSTANT DE REBECQUE, Samuel de	CONSTANT DE REBECQUE, Samuel de			
CONTANT D’ORVILLE, André-Guillaume	CONTANT D’ORVILLE, André-Guillaume	CONTANT D’ORVILLE, André-Guillaume	CONTANT D’ORVILLE, André-Guillaume			
COOPER, Maria Susanna	COOPER, Maria Susanna	COOPER, Maria Susanna	COOPER, Maria Susanna			
COSTARD, Jean-Pierre	COSTARD, Jean-Pierre	COSTARD, Jean-Pierre	COSTARD, Jean-Pierre			
COTENEUVE, de	COTENEUVE, de	COTENEUVE, de	COTENEUVE, de			
COTTIN, Sophie Ristaud, dame	COTTIN, Sophie Ristaud, dame	COTTIN, Sophie Ristaud, dame	COTTIN, Sophie Ristaud, dame			
COURCELLES	COURCELLES	COURCELLES	COURCELLES			
COURET DE VILLENEUVE, Louis-Pierre	COURET DE VILLENEUVE, Louis-Pierre	COURET DE VILLENEUVE, Louis-Pierre	COURET DE VILLENEUVE, Louis-Pierre			
COUSTELIER, Antoine-Urbain, fils	COUSTELIER, Antoine-Urbain, fils	COUSTELIER, Antoine-Urbain, fils	COUSTELIER, Antoine-Urbain, fils			
COUTAN (maitre-boutonnier)	COUTAN (maitre-boutonnier)	COUTAN (maitre-boutonnier)	COUTAN (maitre-boutonnier)			
COVENTRY, Francis	COVENTRY, Francis	COVENTRY, Francis	COVENTRY, Francis			
COYER, abbé Gabriel-François	COYER, abbé Gabriel-François	COYER, abbé Gabriel-François	COYER, abbé Gabriel-François			
CRILLON, Louis-Athanase Des Balbes de Berton, abbé de	CRILLON, Louis-Athanase Des Balbes de Berton, abbé de	CRILLON, Louis-Athanase Des Balbes de Berton, abbé de	CRILLON, Louis-Athanase Des Balbes de Berton, abbé de			
CROCE, Giulio Cesare	CROCE, Giulio Cesare	CROCE, Giulio Cesare	CROCE, Giulio Cesare			
CRÉBILLON, Claude-Prosper Jolyot de	CRÉBILLON, Claude-Prosper Jolyot de	CRÉBILLON, Claude-Prosper Jolyot de	CRÉBILLON, Claude-Prosper Jolyot de			
CUBIÈRES-PALMÉZEAUX, Michel de	CUBIÈRES-PALMÉZEAUX, Michel de	CUBIÈRES-PALMÉZEAUX, Michel de	CUBIÈRES-PALMÉZEAUX, Michel de			
CUMBERLAND, Richard	CUMBERLAND, Richard	CUMBERLAND, Richard	CUMBERLAND, Richard			
CUVELIER DE TRIE, Jean-Guillaume-A.	CUVELIER DE TRIE, Jean-Guillaume-A.	CUVELIER DE TRIE, Jean-Guillaume-A.	CUVELIER DE TRIE, Jean-Guillaume-A.			
DABAYTUA	DABAYTUA	DABAYTUA	DABAYTUA			
DACIER	DACIER	DACIER	DACIER			
DAMIENS DE GOMICOURT, Auguste-Pierre	DAMIENS DE GOMICOURT, Auguste-Pierre	DAMIENS DE GOMICOURT, Auguste-Pierre	DAMIENS DE GOMICOURT, Auguste-Pierre			
DAMIN, Louis	DAMIN, Louis	DAMIN, Louis	DAMIN, Louis			
DANET, abbé Etienne-Jean	DANET, abbé Etienne-Jean	DANET, abbé Etienne-Jean	DANET, abbé Etienne-Jean			
DANTAL, Charles	DANTAL, Charles	DANTAL, Charles	DANTAL, Charles			
DANTE ALIGHIERI	DANTE ALIGHIERI	DANTE ALIGHIERI	DANTE ALIGHIERI			
DANTU, Antoine-Marie	DANTU, Antoine-Marie	DANTU, Antoine-Marie	DANTU, Antoine-Marie			
DAUBENTON, Marguerite	DAUBENTON, Marguerite	DAUBENTON, Marguerite	DAUBENTON, Marguerite			
DAUPHIN	DAUPHIN	DAUPHIN	DAUPHIN			
DAY, Thomas	DAY, Thomas	DAY, Thomas	DAY, Thomas			
DECAMBON VAN DER WERKEN, Maria Gertruida	DECAMBON VAN DER WERKEN, Maria Gertruida	DECAMBON VAN DER WERKEN, Maria Gertruida	DECAMBON VAN DER WERKEN, Maria Gertruida			
DECREMPS, Henri	DECREMPS, Henri	DECREMPS, Henri	DECREMPS, Henri			
DEFOE, Daniel	DEFOE, Daniel	DEFOE, Daniel	DEFOE, Daniel			
DEKEN, madame Agathe	DEKEN, madame Agathe	DEKEN, madame Agathe	DEKEN, madame Agathe			
DELACROIX, Jacques-Vincent	DELACROIX, Jacques-Vincent	DELACROIX, Jacques-Vincent	DELACROIX, Jacques-Vincent			
DELAUNEY	DELAUNEY	DELAUNEY	DELAUNEY			
DELBARE, François-Thomas	DELBARE, François-Thomas	DELBARE, François-Thomas	DELBARE, François-Thomas			
DELINDRE, Jean-Baptiste	DELINDRE, Jean-Baptiste	DELINDRE, Jean-Baptiste	DELINDRE, Jean-Baptiste			
DELISLE DE SALES, Jean-Baptiste-Claude Izouard, dit	DELISLE DE SALES, Jean-Baptiste-Claude Izouard, dit	DELISLE DE SALES, Jean-Baptiste-Claude Izouard, dit	DELISLE DE SALES, Jean-Baptiste-Claude Izouard, dit			
DELLECOURT, Philippe-Joseph	DELLECOURT, Philippe-Joseph	DELLECOURT, Philippe-Joseph	DELLECOURT, Philippe-Joseph			
DELRUE, abbé	DELRUE, abbé	DELRUE, abbé	DELRUE, abbé			
DEMOUSTIER, Charles-Albert	DEMOUSTIER, Charles-Albert	DEMOUSTIER, Charles-Albert	DEMOUSTIER, Charles-Albert			
DENON, baron	DENON, baron	DENON, baron	DENON, baron			
DERESTE	DERESTE	DERESTE	DERESTE			
DES ESSARTS, chevalier	DES ESSARTS, chevalier	DES ESSARTS, chevalier	DES ESSARTS, chevalier			
DESBIEFS, Louis	DESBIEFS, Louis	DESBIEFS, Louis	DESBIEFS, Louis			
DESCHAMPS DE SAUCOURT	DESCHAMPS DE SAUCOURT	DESCHAMPS DE SAUCOURT	DESCHAMPS DE SAUCOURT			
DESFONTAINES, François-Georges Fouques, dit	DESFONTAINES, François-Georges Fouques, dit	DESFONTAINES, François-Georges Fouques, dit	DESFONTAINES, François-Georges Fouques, dit			
DESFORGES, Pierre-Jean-Baptiste Choudard	DESFORGES, Pierre-Jean-Baptiste Choudard	DESFORGES, Pierre-Jean-Baptiste Choudard	DESFORGES, Pierre-Jean-Baptiste Choudard			
DESMARETS	DESMARETS	DESMARETS	DESMARETS			
DEVAINES, Jean	DEVAINES, Jean	DEVAINES, Jean	DEVAINES, Jean			
DIANNYERE, Antoine	DIANNYERE, Antoine	DIANNYERE, Antoine	DIANNYERE, Antoine			
DIDEROT, Denis	DIDEROT, Denis	DIDEROT, Denis	DIDEROT, Denis			
DIDOT, Pierre	DIDOT, Pierre	DIDOT, Pierre	DIDOT, Pierre			
DIGARD DE KERGUETTE, Jean	DIGARD DE KERGUETTE, Jean	DIGARD DE KERGUETTE, Jean	DIGARD DE KERGUETTE, Jean			
DIONIS, mademoiselle	DIONIS, mademoiselle	DIONIS, mademoiselle	DIONIS, mademoiselle			
DIÈRES	DIÈRES	DIÈRES	DIÈRES			
DOGNON, J.-F.	DOGNON, J.-F.	DOGNON, J.-F.	DOGNON, J.-F.			
DOMAIRON, Louis	DOMAIRON, Louis	DOMAIRON, Louis	DOMAIRON, Louis			
DOPPET, François-Amédée	DOPPET, François-Amédée	DOPPET, François-Amédée	DOPPET, François-Amédée			
DORAT, Claude-Joseph	DORAT, Claude-Joseph	DORAT, Claude-Joseph	DORAT, Claude-Joseph			
DORVIGNY, Louis-Archambault	DORVIGNY, Louis-Archambault	DORVIGNY, Louis-Archambault	DORVIGNY, Louis-Archambault			
DU HAUTCHAMP	DU HAUTCHAMP	DU HAUTCHAMP	DU HAUTCHAMP			
DU LAURENS, abbé Henri-Joseph	DU LAURENS, abbé Henri-Joseph	DU LAURENS, abbé Henri-Joseph	DU LAURENS, abbé Henri-Joseph			
DU TERRAIL, Joseph	DU TERRAIL, Joseph	DU TERRAIL, Joseph	DU TERRAIL, Joseph			
DUBOIS-FONTANELLE, Joseph-Gaspard	DUBOIS-FONTANELLE, Joseph-Gaspard	DUBOIS-FONTANELLE, Joseph-Gaspard	DUBOIS-FONTANELLE, Joseph-Gaspard			
DUBOURG	DUBOURG	DUBOURG	DUBOURG			
DUCHÉ DE VANCY, Joseph-François	DUCHÉ DE VANCY, Joseph-François	DUCHÉ DE VANCY, Joseph-François	DUCHÉ DE VANCY, Joseph-François			
DUCLOS, Charles Pinot	DUCLOS, Charles Pinot	DUCLOS, Charles Pinot	DUCLOS, Charles Pinot			
DUCOS, Angélique Caze de La Bove, madame Marie de	DUCOS, Angélique Caze de La Bove, madame Marie de	DUCOS, Angélique Caze de La Bove, madame Marie de	DUCOS, Angélique Caze de La Bove, madame Marie de			
DUCOUDRAY, Alexandre-Jacques Chevalier, dit le chevalier	DUCOUDRAY, Alexandre-Jacques Chevalier, dit le chevalier	DUCOUDRAY, Alexandre-Jacques Chevalier, dit le chevalier	DUCOUDRAY, Alexandre-Jacques Chevalier, dit le chevalier			
DUCRAY-DUMINIL, François-Guillaume	DUCRAY-DUMINIL, François-Guillaume	DUCRAY-DUMINIL, François-Guillaume	DUCRAY-DUMINIL, François-Guillaume			
DUCRY, Sébastien-Joseph	DUCRY, Sébastien-Joseph	DUCRY, Sébastien-Joseph	DUCRY, Sébastien-Joseph			
DUFF, W.	DUFF, W.	DUFF, W.	DUFF, W.			
DUFOUR, P.	DUFOUR, P.	DUFOUR, P.	DUFOUR, P.			
DUFRESNES	DUFRESNES	DUFRESNES	DUFRESNES			
DUGAT, P.-D.	DUGAT, P.-D.	DUGAT, P.-D.	DUGAT, P.-D.			
DULAURE, Jacques -A.	DULAURE, Jacques -A.	DULAURE, Jacques -A.	DULAURE, Jacques -A.			
DULAURENS, abbé Henri-Joseph L’Arrétin	DULAURENS, abbé Henri-Joseph L’Arrétin	DULAURENS, abbé Henri-Joseph L’Arrétin	DULAURENS, abbé Henri-Joseph L’Arrétin			
DULAURENT	DULAURENT	DULAURENT	DULAURENT			
DUMARQUET, abbé Louis-Joseph	DUMARQUET, abbé Louis-Joseph	DUMARQUET, abbé Louis-Joseph	DUMARQUET, abbé Louis-Joseph			
DUMONT, madame, née Lutel	DUMONT, madame, née Lutel	DUMONT, madame, née Lutel	DUMONT, madame, née Lutel			
DUPLESSIS, chevalier Pierre	DUPLESSIS, chevalier Pierre	DUPLESSIS, chevalier Pierre	DUPLESSIS, chevalier Pierre			
DUPLESSY, baronne Alexandrine de	DUPLESSY, baronne Alexandrine de	DUPLESSY, baronne Alexandrine de	DUPLESSY, baronne Alexandrine de			
DURAND, Antoine-Joseph	DURAND, Antoine-Joseph	DURAND, Antoine-Joseph	DURAND, Antoine-Joseph			
DUSAUSOIR, François-Jean	DUSAUSOIR, François-Jean	DUSAUSOIR, François-Jean	DUSAUSOIR, François-Jean			
DUVAL-PYRAU, abbé	DUVAL-PYRAU, abbé	DUVAL-PYRAU, abbé	DUVAL-PYRAU, abbé			
DUVERNET, abbé Théophile-Imarigeon	DUVERNET, abbé Théophile-Imarigeon	DUVERNET, abbé Théophile-Imarigeon	DUVERNET, abbé Théophile-Imarigeon			
DUWICQUET D’ORDRE, Louis-Alexandre, père	DUWICQUET D’ORDRE, Louis-Alexandre, père	DUWICQUET D’ORDRE, Louis-Alexandre, père	DUWICQUET D’ORDRE, Louis-Alexandre, père			
DÉJARDIN DE COURCELLES, madame, née Tournay	DÉJARDIN DE COURCELLES, madame, née Tournay	DÉJARDIN DE COURCELLES, madame, née Tournay	DÉJARDIN DE COURCELLES, madame, née Tournay			
ELIE DE BEAUMONT, Anne-Louise Dumesnil-Molin, madame	ELIE DE BEAUMONT, Anne-Louise Dumesnil-Molin, madame	ELIE DE BEAUMONT, Anne-Louise Dumesnil-Molin, madame	ELIE DE BEAUMONT, Anne-Louise Dumesnil-Molin, madame			
EPINAY, Louise-Florence-Pétronille Tardieu d’Esclavelles, marquise d’	EPINAY, Louise-Florence-Pétronille Tardieu d’Esclavelles, marquise d’	EPINAY, Louise-Florence-Pétronille Tardieu d’Esclavelles, marquise d’	EPINAY, Louise-Florence-Pétronille Tardieu d’Esclavelles, marquise d’			
ERLACH, Rodolphe-Louis d’	ERLACH, Rodolphe-Louis d’	ERLACH, Rodolphe-Louis d’	ERLACH, Rodolphe-Louis d’			
ESTRADE	ESTRADE	ESTRADE	ESTRADE			
ESTÈVE, Pierre	ESTÈVE, Pierre	ESTÈVE, Pierre	ESTÈVE, Pierre			
FABRE D’OLIVET, Antoine	FABRE D’OLIVET, Antoine	FABRE D’OLIVET, Antoine	FABRE D’OLIVET, Antoine			
FAGNAN, Marie-Antoinette	FAGNAN, Marie-Antoinette	FAGNAN, Marie-Antoinette	FAGNAN, Marie-Antoinette			
FALCONET, Ambroise	FALCONET, Ambroise	FALCONET, Ambroise	FALCONET, Ambroise			
FALQUES, Marianne-Agnès	FALQUES, Marianne-Agnès	FALQUES, Marianne-Agnès	FALQUES, Marianne-Agnès			
FANTIN-DESODOARDS, Antoine-Etienne-Nicolas	FANTIN-DESODOARDS, Antoine-Etienne-Nicolas	FANTIN-DESODOARDS, Antoine-Etienne-Nicolas	FANTIN-DESODOARDS, Antoine-Etienne-Nicolas			
FEITH, Rhinjvis	FEITH, Rhinjvis	FEITH, Rhinjvis	FEITH, Rhinjvis			
FENESTRE DE HOTOT, Pierre-Alexandre-Eléonor	FENESTRE DE HOTOT, Pierre-Alexandre-Eléonor	FENESTRE DE HOTOT, Pierre-Alexandre-Eléonor	FENESTRE DE HOTOT, Pierre-Alexandre-Eléonor			
FERRIÈRES, Charles-Elie, marquis de	FERRIÈRES, Charles-Elie, marquis de	FERRIÈRES, Charles-Elie, marquis de	FERRIÈRES, Charles-Elie, marquis de			
FEUTRY, Aimé-Ambroise-Joseph	FEUTRY, Aimé-Ambroise-Joseph	FEUTRY, Aimé-Ambroise-Joseph	FEUTRY, Aimé-Ambroise-Joseph			
FIELDING, Henry	FIELDING, Henry	FIELDING, Henry	FIELDING, Henry			
FIELDING, Sarah	FIELDING, Sarah	FIELDING, Sarah	FIELDING, Sarah			
FISCHER, Christian August	FISCHER, Christian August	FISCHER, Christian August	FISCHER, Christian August			
FISCHER, Johann Karl Christian	FISCHER, Johann Karl Christian	FISCHER, Johann Karl Christian	FISCHER, Johann Karl Christian			
FIÉVÉE, Joseph	FIÉVÉE, Joseph	FIÉVÉE, Joseph	FIÉVÉE, Joseph			
FLEURIOT, Jean-Marie-Jérôme, marquis de	FLEURIOT, Jean-Marie-Jérôme, marquis de	FLEURIOT, Jean-Marie-Jérôme, marquis de	FLEURIOT, Jean-Marie-Jérôme, marquis de			
FLORIAN, Jean-Pierre	FLORIAN, Jean-Pierre	FLORIAN, Jean-Pierre	FLORIAN, Jean-Pierre			
FLORIAN, Jean-Pierre Claris de	FLORIAN, Jean-Pierre Claris de	FLORIAN, Jean-Pierre Claris de	FLORIAN, Jean-Pierre Claris de			
FONTENELLE, Bernard	FONTENELLE, Bernard	FONTENELLE, Bernard	FONTENELLE, Bernard			
FONTETTE DE SOMMERY, mademoiselle	FONTETTE DE SOMMERY, mademoiselle	FONTETTE DE SOMMERY, mademoiselle	FONTETTE DE SOMMERY, mademoiselle			
FORTIA DE PILES, Alphonse-Toussaint-Joseph-André-Marie Marseille, comte de	FORTIA DE PILES, Alphonse-Toussaint-Joseph-André-Marie Marseille, comte de	FORTIA DE PILES, Alphonse-Toussaint-Joseph-André-Marie Marseille, comte de	FORTIA DE PILES, Alphonse-Toussaint-Joseph-André-Marie Marseille, comte de			
FORTIA D’URBAN, Agricole-Joseph-François-Xavier-Pierre-Esprit-Simon-Paul-Antoine, marquis de	FORTIA D’URBAN, Agricole-Joseph-François-Xavier-Pierre-Esprit-Simon-Paul-Antoine, marquis de	FORTIA D’URBAN, Agricole-Joseph-François-Xavier-Pierre-Esprit-Simon-Paul-Antoine, marquis de	FORTIA D’URBAN, Agricole-Joseph-François-Xavier-Pierre-Esprit-Simon-Paul-Antoine, marquis de			
FOURNIER DE TONY	FOURNIER DE TONY	FOURNIER DE TONY	FOURNIER DE TONY			
FOURQUEUX, madame de	FOURQUEUX, madame de	FOURQUEUX, madame de	FOURQUEUX, madame de			
FOX, John	FOX, John	FOX, John	FOX, John			
FRAMERY, Nicolas-Etienne	FRAMERY, Nicolas-Etienne	FRAMERY, Nicolas-Etienne	FRAMERY, Nicolas-Etienne			
FRENAIS, Joseph-Pierre	FRENAIS, Joseph-Pierre	FRENAIS, Joseph-Pierre	FRENAIS, Joseph-Pierre			
FRÉDÉRIC II, le Grand, roi de Prusse	FRÉDÉRIC II, le Grand, roi de Prusse	FRÉDÉRIC II, le Grand, roi de Prusse	FRÉDÉRIC II, le Grand, roi de Prusse			
FRÉVILLE, Anne-François-Joachim	FRÉVILLE, Anne-François-Joachim	FRÉVILLE, Anne-François-Joachim	FRÉVILLE, Anne-François-Joachim			
FULCHIRON, Jean-Claude	FULCHIRON, Jean-Claude	FULCHIRON, Jean-Claude	FULCHIRON, Jean-Claude			
FULLER, Anne	FULLER, Anne	FULLER, Anne	FULLER, Anne			
FUMELH, madame de	FUMELH, madame de	FUMELH, madame de	FUMELH, madame de			
FYOT DE LA MARCHE, Jean-Philippe	FYOT DE LA MARCHE, Jean-Philippe	FYOT DE LA MARCHE, Jean-Philippe	FYOT DE LA MARCHE, Jean-Philippe			
GACON-DUFOUR, Marie-Armande-Jeanne d’Humières, madame	GACON-DUFOUR, Marie-Armande-Jeanne d’Humières, madame	GACON-DUFOUR, Marie-Armande-Jeanne d’Humières, madame	GACON-DUFOUR, Marie-Armande-Jeanne d’Humières, madame			
GAIN DE MONTAGNAC, Louis-Laurent-Joseph	GAIN DE MONTAGNAC, Louis-Laurent-Joseph	GAIN DE MONTAGNAC, Louis-Laurent-Joseph	GAIN DE MONTAGNAC, Louis-Laurent-Joseph			
GALLAIS, Jean-Pierre	GALLAIS, Jean-Pierre	GALLAIS, Jean-Pierre	GALLAIS, Jean-Pierre			
GALTIER, Jean-Louis, dit Galtier de Saint-Symphorien	GALTIER, Jean-Louis, dit Galtier de Saint-Symphorien	GALTIER, Jean-Louis, dit Galtier de Saint-Symphorien	GALTIER, Jean-Louis, dit Galtier de Saint-Symphorien			
GANIFEY	GANIFEY	GANIFEY	GANIFEY			
GARDY, J.-A.	GARDY, J.-A.	GARDY, J.-A.	GARDY, J.-A.			
GARNIER, Charles-Georges-Thomas	GARNIER, Charles-Georges-Thomas	GARNIER, Charles-Georges-Thomas	GARNIER, Charles-Georges-Thomas			
GASCHIGNARD, P.	GASCHIGNARD, P.	GASCHIGNARD, P.	GASCHIGNARD, P.			
GATREY	GATREY	GATREY	GATREY			
GAUCHAT, abbé Gabriel	GAUCHAT, abbé Gabriel	GAUCHAT, abbé Gabriel	GAUCHAT, abbé Gabriel			
GAUDE	GAUDE	GAUDE	GAUDE			
GAUDIN DE LAGRANGE	GAUDIN DE LAGRANGE	GAUDIN DE LAGRANGE	GAUDIN DE LAGRANGE			
GAUTHIER, madame de	GAUTHIER, madame de	GAUTHIER, madame de	GAUTHIER, madame de			
GAUTIER DE MONTDORGE, Antoine	GAUTIER DE MONTDORGE, Antoine	GAUTIER DE MONTDORGE, Antoine	GAUTIER DE MONTDORGE, Antoine			
GAUTIER, abbé Jean-Jacques	GAUTIER, abbé Jean-Jacques	GAUTIER, abbé Jean-Jacques	GAUTIER, abbé Jean-Jacques			
GAUTIER-LACÉPÈDE, madame	GAUTIER-LACÉPÈDE, madame	GAUTIER-LACÉPÈDE, madame	GAUTIER-LACÉPÈDE, madame			
GAY, John	GAY, John	GAY, John	GAY, John			
GELLERT, Christian Furchtegott	GELLERT, Christian Furchtegott	GELLERT, Christian Furchtegott	GELLERT, Christian Furchtegott			
GENLIS, Stéphanie-Félicité Ducrest de Saint-Aubin, marquise de Sillery, comtesse de	GENLIS, Stéphanie-Félicité Ducrest de Saint-Aubin, marquise de Sillery, comtesse de	GENLIS, Stéphanie-Félicité Ducrest de Saint-Aubin, marquise de Sillery, comtesse de	GENLIS, Stéphanie-Félicité Ducrest de Saint-Aubin, marquise de Sillery, comtesse de			
GESSNER, Salomon	GESSNER, Salomon	GESSNER, Salomon	GESSNER, Salomon			
GETNON-VILLE, comtesse de	GETNON-VILLE, comtesse de	GETNON-VILLE, comtesse de	GETNON-VILLE, comtesse de			
GILBERT, Nicolas-Joseph-Laurent	GILBERT, Nicolas-Joseph-Laurent	GILBERT, Nicolas-Joseph-Laurent	GILBERT, Nicolas-Joseph-Laurent			
GIMAT DE BONNEVAL, Jean-Baptiste	GIMAT DE BONNEVAL, Jean-Baptiste	GIMAT DE BONNEVAL, Jean-Baptiste	GIMAT DE BONNEVAL, Jean-Baptiste			
GINGINS, V. de	GINGINS, V. de	GINGINS, V. de	GINGINS, V. de			
GIRARD, Joseph-François-Henri de	GIRARD, Joseph-François-Henri de	GIRARD, Joseph-François-Henri de	GIRARD, Joseph-François-Henri de			
GIRARD-RAIGNÉ, R.	GIRARD-RAIGNÉ, R.	GIRARD-RAIGNÉ, R.	GIRARD-RAIGNÉ, R.			
GIRARDIN, René-Louis, marquis de	GIRARDIN, René-Louis, marquis de	GIRARDIN, René-Louis, marquis de	GIRARDIN, René-Louis, marquis de			
GIRAUD, Claude-Marie	GIRAUD, Claude-Marie	GIRAUD, Claude-Marie	GIRAUD, Claude-Marie			
GIRAUDEAU, le père Bonaventure	GIRAUDEAU, le père Bonaventure	GIRAUDEAU, le père Bonaventure	GIRAUDEAU, le père Bonaventure			
GIROD, abbé Charles-Jean	GIROD, abbé Charles-Jean	GIROD, abbé Charles-Jean	GIROD, abbé Charles-Jean			
GIRONNET	GIRONNET	GIRONNET	GIRONNET			
GODARD D’AUCOUR, Claude	GODARD D’AUCOUR, Claude	GODARD D’AUCOUR, Claude	GODARD D’AUCOUR, Claude			
GODWIN, Mary Wollstonecraft, Mrs	GODWIN, Mary Wollstonecraft, Mrs	GODWIN, Mary Wollstonecraft, Mrs	GODWIN, Mary Wollstonecraft, Mrs			
GODWIN, William	GODWIN, William	GODWIN, William	GODWIN, William			
GOETHE, Johann Wolfgang von	GOETHE, Johann Wolfgang von	GOETHE, Johann Wolfgang von	GOETHE, Johann Wolfgang von			
GOLDSMITH, Oliver	GOLDSMITH, Oliver	GOLDSMITH, Oliver	GOLDSMITH, Oliver			
GOODRICKJE, Henry	GOODRICKJE, Henry	GOODRICKJE, Henry	GOODRICKJE, Henry			
GORJY, Jean-Claude	GORJY, Jean-Claude	GORJY, Jean-Claude	GORJY, Jean-Claude			
GOSSE, Étienne	GOSSE, Étienne	GOSSE, Étienne	GOSSE, Étienne			
GOUDAR, Ange	GOUDAR, Ange	GOUDAR, Ange	GOUDAR, Ange			
GOUGES, Marie Gouze, dite Olympe de	GOUGES, Marie Gouze, dite Olympe de	GOUGES, Marie Gouze, dite Olympe de	GOUGES, Marie Gouze, dite Olympe de			
GOULLIART, P.-L.	GOULLIART, P.-L.	GOULLIART, P.-L.	GOULLIART, P.-L.			
GOURBILLON, C.	GOURBILLON, C.	GOURBILLON, C.	GOURBILLON, C.			
GRAILLARD DE GRAVILLE, Barthélemy-Claude	GRAILLARD DE GRAVILLE, Barthélemy-Claude	GRAILLARD DE GRAVILLE, Barthélemy-Claude	GRAILLARD DE GRAVILLE, Barthélemy-Claude			
GRAINVILLE, Jean-Baptiste-Christophe	GRAINVILLE, Jean-Baptiste-Christophe	GRAINVILLE, Jean-Baptiste-Christophe	GRAINVILLE, Jean-Baptiste-Christophe			
GRANDIN, Charles-François	GRANDIN, Charles-François	GRANDIN, Charles-François	GRANDIN, Charles-François			
GRANDMAISON VAN ESBECQ, madame	GRANDMAISON VAN ESBECQ, madame	GRANDMAISON VAN ESBECQ, madame	GRANDMAISON VAN ESBECQ, madame			
GRASSET-SAINT-SAUVEUR, Jacques	GRASSET-SAINT-SAUVEUR, Jacques	GRASSET-SAINT-SAUVEUR, Jacques	GRASSET-SAINT-SAUVEUR, Jacques			
GRAVE, P.-M. de	GRAVE, P.-M. de	GRAVE, P.-M. de	GRAVE, P.-M. de			
GRAZZINI, Anton Francesco, dit il Lasca	GRAZZINI, Anton Francesco, dit il Lasca	GRAZZINI, Anton Francesco, dit il Lasca	GRAZZINI, Anton Francesco, dit il Lasca			
GRIFFET DE LABAUME, Antoine-Gilbert	GRIFFET DE LABAUME, Antoine-Gilbert	GRIFFET DE LABAUME, Antoine-Gilbert	GRIFFET DE LABAUME, Antoine-Gilbert			
GRIFFITH, Mrs Elizabeth	GRIFFITH, Mrs Elizabeth	GRIFFITH, Mrs Elizabeth	GRIFFITH, Mrs Elizabeth			
GRIMM, Friedrich Melchior, baron	GRIMM, Friedrich Melchior, baron	GRIMM, Friedrich Melchior, baron	GRIMM, Friedrich Melchior, baron			
GRIVEL, Guillaume	GRIVEL, Guillaume	GRIVEL, Guillaume	GRIVEL, Guillaume			
GROS DE BESPLAS, abbé Joseph-Marie	GROS DE BESPLAS, abbé Joseph-Marie	GROS DE BESPLAS, abbé Joseph-Marie	GROS DE BESPLAS, abbé Joseph-Marie			
GUER, Julien-Hyacinthe de	GUER, Julien-Hyacinthe de	GUER, Julien-Hyacinthe de	GUER, Julien-Hyacinthe de			
GUEULETTE, Thomas-Simon	GUEULETTE, Thomas-Simon	GUEULETTE, Thomas-Simon	GUEULETTE, Thomas-Simon			
GUIBAUD, le père Eustache	GUIBAUD, le père Eustache	GUIBAUD, le père Eustache	GUIBAUD, le père Eustache			
GUICHARD, Eléonore	GUICHARD, Eléonore	GUICHARD, Eléonore	GUICHARD, Eléonore			
GUICHARD, Jean-François	GUICHARD, Jean-François	GUICHARD, Jean-François	GUICHARD, Jean-François			
GUILLOT DE LA CHASSAGNE, abbé Ignace-Vincent	GUILLOT DE LA CHASSAGNE, abbé Ignace-Vincent	GUILLOT DE LA CHASSAGNE, abbé Ignace-Vincent	GUILLOT DE LA CHASSAGNE, abbé Ignace-Vincent			
GUIZOT, madame Pauline de, née Meulan	GUIZOT, madame Pauline de, née Meulan	GUIZOT, madame Pauline de, née Meulan	GUIZOT, madame Pauline de, née Meulan			
GUNNING, Suzannah	GUNNING, Suzannah	GUNNING, Suzannah	GUNNING, Suzannah			
GUYS, Jean-Baptiste	GUYS, Jean-Baptiste	GUYS, Jean-Baptiste	GUYS, Jean-Baptiste			
GUÉRINEAU DE SAINT-PÉRAVI, Jean-Nicolas-Marcellin	GUÉRINEAU DE SAINT-PÉRAVI, Jean-Nicolas-Marcellin	GUÉRINEAU DE SAINT-PÉRAVI, Jean-Nicolas-Marcellin	GUÉRINEAU DE SAINT-PÉRAVI, Jean-Nicolas-Marcellin			
GÉRARD, Philippe-Louis	GÉRARD, Philippe-Louis	GÉRARD, Philippe-Louis	GÉRARD, Philippe-Louis			
HACOT, Joseph	HACOT, Joseph	HACOT, Joseph	HACOT, Joseph			
HALLER, Albrecht von	HALLER, Albrecht von	HALLER, Albrecht von	HALLER, Albrecht von			
HAMILTON, comte Antoine	HAMILTON, comte Antoine	HAMILTON, comte Antoine	HAMILTON, comte Antoine			
HAREN, Willem van	HAREN, Willem van	HAREN, Willem van	HAREN, Willem van			
HARNY DE GUERVILLE	HARNY DE GUERVILLE	HARNY DE GUERVILLE	HARNY DE GUERVILLE			
HARTIG, Franz, Graf von	HARTIG, Franz, Graf von	HARTIG, Franz, Graf von	HARTIG, Franz, Graf von			
HAUDART	HAUDART	HAUDART	HAUDART			
HAUDRY, mademoiselle	HAUDRY, mademoiselle	HAUDRY, mademoiselle	HAUDRY, mademoiselle			
HAVE, Adrien-Joseph	HAVE, Adrien-Joseph	HAVE, Adrien-Joseph	HAVE, Adrien-Joseph			
HAWKE, lady Cassandra	HAWKE, lady Cassandra	HAWKE, lady Cassandra	HAWKE, lady Cassandra			
HAWKESWORTH, John	HAWKESWORTH, John	HAWKESWORTH, John	HAWKESWORTH, John			
HAYLEY, William	HAYLEY, William	HAYLEY, William	HAYLEY, William			
HAYS, Mary	HAYS, Mary	HAYS, Mary	HAYS, Mary			
HAYWOOD, Eliza	HAYWOOD, Eliza	HAYWOOD, Eliza	HAYWOOD, Eliza			
HEDGELAND, Isabelle Kelly, Mrs	HEDGELAND, Isabelle Kelly, Mrs	HEDGELAND, Isabelle Kelly, Mrs	HEDGELAND, Isabelle Kelly, Mrs			
HEINSE, Johann Jacob Wilhelm	HEINSE, Johann Jacob Wilhelm	HEINSE, Johann Jacob Wilhelm	HEINSE, Johann Jacob Wilhelm			
HELAINE, abbé	HELAINE, abbé	HELAINE, abbé	HELAINE, abbé			
HELME, Elizabeth	HELME, Elizabeth	HELME, Elizabeth	HELME, Elizabeth			
HEMPEL	HEMPEL	HEMPEL	HEMPEL			
HENRION, Charles	HENRION, Charles	HENRION, Charles	HENRION, Charles			
HENRIQUEZ, L.-M.	HENRIQUEZ, L.-M.	HENRIQUEZ, L.-M.	HENRIQUEZ, L.-M.			
HERIOT, John	HERIOT, John	HERIOT, John	HERIOT, John			
HERTZBERG (professeur de l’Université de Strasbourg)	HERTZBERG (professeur de l’Université de Strasbourg)	HERTZBERG (professeur de l’Université de Strasbourg)	HERTZBERG (professeur de l’Université de Strasbourg)			
HERVEY, Elizabeth	HERVEY, Elizabeth	HERVEY, Elizabeth	HERVEY, Elizabeth			
HILL, sir John	HILL, sir John	HILL, sir John	HILL, sir John			
HILLIARD D’AUBERTEUIL, Michel-René	HILLIARD D’AUBERTEUIL, Michel-René	HILLIARD D’AUBERTEUIL, Michel-René	HILLIARD D’AUBERTEUIL, Michel-René			
HOLCROFT, Thomas	HOLCROFT, Thomas	HOLCROFT, Thomas	HOLCROFT, Thomas			
HOMÈRE	HOMÈRE	HOMÈRE	HOMÈRE			
HOURCASTREMÉ, Pierre	HOURCASTREMÉ, Pierre	HOURCASTREMÉ, Pierre	HOURCASTREMÉ, Pierre			
HOWELL, Mrs	HOWELL, Mrs	HOWELL, Mrs	HOWELL, Mrs			
HUBERT (d’Orléans)	HUBERT (d’Orléans)	HUBERT (d’Orléans)	HUBERT (d’Orléans)			
HUBIN, Jean-Hubert	HUBIN, Jean-Hubert	HUBIN, Jean-Hubert	HUBIN, Jean-Hubert			
HUERNE DE LA MOTHE, François-Charles	HUERNE DE LA MOTHE, François-Charles	HUERNE DE LA MOTHE, François-Charles	HUERNE DE LA MOTHE, François-Charles			
HUGELL, Mrs Harley, ensuite	HUGELL, Mrs Harley, ensuite	HUGELL, Mrs Harley, ensuite	HUGELL, Mrs Harley, ensuite			
HUGHES, Mrs Anne	HUGHES, Mrs Anne	HUGHES, Mrs Anne	HUGHES, Mrs Anne			
IMBERT, Barthélemy	IMBERT, Barthélemy	IMBERT, Barthélemy	IMBERT, Barthélemy			
INCHBALD, Elizabeth Simpson, Mrs	INCHBALD, Elizabeth Simpson, Mrs	INCHBALD, Elizabeth Simpson, Mrs	INCHBALD, Elizabeth Simpson, Mrs			
INÀYAT-ALLÂH	INÀYAT-ALLÂH	INÀYAT-ALLÂH	INÀYAT-ALLÂH			
JACOBI, Friedrich Heinrich	JACOBI, Friedrich Heinrich	JACOBI, Friedrich Heinrich	JACOBI, Friedrich Heinrich			
JACOBI, Johann Georg	JACOBI, Johann Georg	JACOBI, Johann Georg	JACOBI, Johann Georg			
JACQUIN, abbé Armand-Pierre	JACQUIN, abbé Armand-Pierre	JACQUIN, abbé Armand-Pierre	JACQUIN, abbé Armand-Pierre			
JAMES, W.	JAMES, W.	JAMES, W.	JAMES, W.			
JAUFFRET, Louis-François	JAUFFRET, Louis-François	JAUFFRET, Louis-François	JAUFFRET, Louis-François			
JOHNSON, Anna Maria	JOHNSON, Anna Maria	JOHNSON, Anna Maria	JOHNSON, Anna Maria			
JOHNSON, Samuel	JOHNSON, Samuel	JOHNSON, Samuel	JOHNSON, Samuel			
JOHNSTON, Charles	JOHNSTON, Charles	JOHNSTON, Charles	JOHNSTON, Charles			
JOLICART	JOLICART	JOLICART	JOLICART			
JOLY, le père Joseph-Romain	JOLY, le père Joseph-Romain	JOLY, le père Joseph-Romain	JOLY, le père Joseph-Romain			
JONVAL	JONVAL	JONVAL	JONVAL			
JORE, Claude-François	JORE, Claude-François	JORE, Claude-François	JORE, Claude-François			
JOUY, Victor-Joseph-Etienne de	JOUY, Victor-Joseph-Etienne de	JOUY, Victor-Joseph-Etienne de	JOUY, Victor-Joseph-Etienne de			
JULLIEN, Jean-Auguste, dit Desboulmiers	JULLIEN, Jean-Auguste, dit Desboulmiers	JULLIEN, Jean-Auguste, dit Desboulmiers	JULLIEN, Jean-Auguste, dit Desboulmiers			
JUNG STILLING, Johann Heinrich Jung, dit	JUNG STILLING, Johann Heinrich Jung, dit	JUNG STILLING, Johann Heinrich Jung, dit	JUNG STILLING, Johann Heinrich Jung, dit			
JUVÉNAL	JUVÉNAL	JUVÉNAL	JUVÉNAL			
JÜNGER, Johann Friedrich	JÜNGER, Johann Friedrich	JÜNGER, Johann Friedrich	JÜNGER, Johann Friedrich			
KARAMZIN, Nikolaï Mikhaïlovitch	KARAMZIN, Nikolaï Mikhaïlovitch	KARAMZIN, Nikolaï Mikhaïlovitch	KARAMZIN, Nikolaï Mikhaïlovitch			
KEIR, Mrs	KEIR, Mrs	KEIR, Mrs	KEIR, Mrs			
KELLY, Hugh	KELLY, Hugh	KELLY, Hugh	KELLY, Hugh			
KENDALL, A.	KENDALL, A.	KENDALL, A.	KENDALL, A.			
KIMBER, Edward	KIMBER, Edward	KIMBER, Edward	KIMBER, Edward			
KING, Sophia	KING, Sophia	KING, Sophia	KING, Sophia			
KJÉRALIO, Marie-Françoise Abeille, madame de	KJÉRALIO, Marie-Françoise Abeille, madame de	KJÉRALIO, Marie-Françoise Abeille, madame de	KJÉRALIO, Marie-Françoise Abeille, madame de			
KLINGER, Friedrich Maximilian	KLINGER, Friedrich Maximilian	KLINGER, Friedrich Maximilian	KLINGER, Friedrich Maximilian			
KLOPSTOCK, Friedrich Gottlieb	KLOPSTOCK, Friedrich Gottlieb	KLOPSTOCK, Friedrich Gottlieb	KLOPSTOCK, Friedrich Gottlieb			
KNIGGE, Adolph Franz Friedrich Ludwig, Freiherr von	KNIGGE, Adolph Franz Friedrich Ludwig, Freiherr von	KNIGGE, Adolph Franz Friedrich Ludwig, Freiherr von	KNIGGE, Adolph Franz Friedrich Ludwig, Freiherr von			
KORN, Christoph Heinrich	KORN, Christoph Heinrich	KORN, Christoph Heinrich	KORN, Christoph Heinrich			
KOTZEBUE, August Friedrich Ferdinand von	KOTZEBUE, August Friedrich Ferdinand von	KOTZEBUE, August Friedrich Ferdinand von	KOTZEBUE, August Friedrich Ferdinand von			
KÉRATRY, Auguste-Hilarion de	KÉRATRY, Auguste-Hilarion de	KÉRATRY, Auguste-Hilarion de	KÉRATRY, Auguste-Hilarion de			
KÉRAUO, Marie-Françoise Abeille, madame de	KÉRAUO, Marie-Françoise Abeille, madame de	KÉRAUO, Marie-Françoise Abeille, madame de	KÉRAUO, Marie-Françoise Abeille, madame de			
KÜHNE, F.-Th.	KÜHNE, F.-Th.	KÜHNE, F.-Th.	KÜHNE, F.-Th.			
LA BARRE	LA BARRE	LA BARRE	LA BARRE			
LA BEAUMELLE, Laurent Angliviel de	LA BEAUMELLE, Laurent Angliviel de	LA BEAUMELLE, Laurent Angliviel de	LA BEAUMELLE, Laurent Angliviel de			
LA BORDE, Jean-Benjamin de	LA BORDE, Jean-Benjamin de	LA BORDE, Jean-Benjamin de	LA BORDE, Jean-Benjamin de			
LA CALPRENÈDE, Gautier de Coste de	LA CALPRENÈDE, Gautier de Coste de	LA CALPRENÈDE, Gautier de Coste de	LA CALPRENÈDE, Gautier de Coste de			
LA FOLIE, C.-L. de	LA FOLIE, C.-L. de	LA FOLIE, C.-L. de	LA FOLIE, C.-L. de			
LA GRAVE, comtesse de	LA GRAVE, comtesse de	LA GRAVE, comtesse de	LA GRAVE, comtesse de			
LA GUESNERIE, Charlotte-Marie-Anne Charbonnier de	LA GUESNERIE, Charlotte-Marie-Anne Charbonnier de	LA GUESNERIE, Charlotte-Marie-Anne Charbonnier de	LA GUESNERIE, Charlotte-Marie-Anne Charbonnier de			
LA MORLIÈRE, chevalier Charles-Jacques-Louis-Auguste Rochette de	LA MORLIÈRE, chevalier Charles-Jacques-Louis-Auguste Rochette de	LA MORLIÈRE, chevalier Charles-Jacques-Louis-Auguste Rochette de	LA MORLIÈRE, chevalier Charles-Jacques-Louis-Auguste Rochette de			
LA PLACE, Pierre-Antoine de	LA PLACE, Pierre-Antoine de	LA PLACE, Pierre-Antoine de	LA PLACE, Pierre-Antoine de			
LA POPELINIÈRE, Alexandre-Jean-Joseph Le Riche de	LA POPELINIÈRE, Alexandre-Jean-Joseph Le Riche de	LA POPELINIÈRE, Alexandre-Jean-Joseph Le Riche de	LA POPELINIÈRE, Alexandre-Jean-Joseph Le Riche de			
LA REYNIE DE LA BRUYÈRE, abbé Jean-Baptiste-Marie-Louis de	LA REYNIE DE LA BRUYÈRE, abbé Jean-Baptiste-Marie-Louis de	LA REYNIE DE LA BRUYÈRE, abbé Jean-Baptiste-Marie-Louis de	LA REYNIE DE LA BRUYÈRE, abbé Jean-Baptiste-Marie-Louis de			
LA ROCHE, A.-C.-N. de Gosquinet de	LA ROCHE, A.-C.-N. de Gosquinet de	LA ROCHE, A.-C.-N. de Gosquinet de	LA ROCHE, A.-C.-N. de Gosquinet de			
LA ROCHE, Maria Sophie Gutermann, Frau von	LA ROCHE, Maria Sophie Gutermann, Frau von	LA ROCHE, Maria Sophie Gutermann, Frau von	LA ROCHE, Maria Sophie Gutermann, Frau von			
LA ROCHEFOUCAULD-SURGÈRES, Jean-François de	LA ROCHEFOUCAULD-SURGÈRES, Jean-François de	LA ROCHEFOUCAULD-SURGÈRES, Jean-François de	LA ROCHEFOUCAULD-SURGÈRES, Jean-François de			
LA ROCHELLE, L.-F.-G. B... de	LA ROCHELLE, L.-F.-G. B... de	LA ROCHELLE, L.-F.-G. B... de	LA ROCHELLE, L.-F.-G. B... de			
LA SALLE D’OFFÉMONT, Adrien-Nicolas Piédefer, marquis de	LA SALLE D’OFFÉMONT, Adrien-Nicolas Piédefer, marquis de	LA SALLE D’OFFÉMONT, Adrien-Nicolas Piédefer, marquis de	LA SALLE D’OFFÉMONT, Adrien-Nicolas Piédefer, marquis de			
LA SERRIE, François-Joseph de	LA SERRIE, François-Joseph de	LA SERRIE, François-Joseph de	LA SERRIE, François-Joseph de			
LA SOLLE, Henri-François de	LA SOLLE, Henri-François de	LA SOLLE, Henri-François de	LA SOLLE, Henri-François de			
LA VEAUX, Jean-Charles-Thibault de	LA VEAUX, Jean-Charles-Thibault de	LA VEAUX, Jean-Charles-Thibault de	LA VEAUX, Jean-Charles-Thibault de			
LABAUME-DESDOSSAT, abbé Jacques-François de	LABAUME-DESDOSSAT, abbé Jacques-François de	LABAUME-DESDOSSAT, abbé Jacques-François de	LABAUME-DESDOSSAT, abbé Jacques-François de			
LABLÉE, Jacques	LABLÉE, Jacques	LABLÉE, Jacques	LABLÉE, Jacques			
LABOUREYS, madame de	LABOUREYS, madame de	LABOUREYS, madame de	LABOUREYS, madame de			
LACOSTE, Jean-Baptiste	LACOSTE, Jean-Baptiste	LACOSTE, Jean-Baptiste	LACOSTE, Jean-Baptiste			
LACROIX, Pierre-Firmin de	LACROIX, Pierre-Firmin de	LACROIX, Pierre-Firmin de	LACROIX, Pierre-Firmin de			
LAFITE DE PELLEPORT, Anne-Gédéon	LAFITE DE PELLEPORT, Anne-Gédéon	LAFITE DE PELLEPORT, Anne-Gédéon	LAFITE DE PELLEPORT, Anne-Gédéon			
LAFITE, Marie-Elisabeth Bouée, madame de	LAFITE, Marie-Elisabeth Bouée, madame de	LAFITE, Marie-Elisabeth Bouée, madame de	LAFITE, Marie-Elisabeth Bouée, madame de			
LAFONT, F.-Gaspard	LAFONT, F.-Gaspard	LAFONT, F.-Gaspard	LAFONT, F.-Gaspard			
LAFONTAINE, August Heinrich Julius	LAFONTAINE, August Heinrich Julius	LAFONTAINE, August Heinrich Julius	LAFONTAINE, August Heinrich Julius			
LAISNÉ, Nicolas-Gabriel	LAISNÉ, Nicolas-Gabriel	LAISNÉ, Nicolas-Gabriel	LAISNÉ, Nicolas-Gabriel			
LAISSE, madame de	LAISSE, madame de	LAISSE, madame de	LAISSE, madame de			
LAMBERG, Maximilien, Graf von	LAMBERG, Maximilien, Graf von	LAMBERG, Maximilien, Graf von	LAMBERG, Maximilien, Graf von			
LAMBERT, abbé Claude-François	LAMBERT, abbé Claude-François	LAMBERT, abbé Claude-François	LAMBERT, abbé Claude-François			
LANCELIN	LANCELIN	LANCELIN	LANCELIN			
LANDON, Jean-Joseph	LANDON, Jean-Joseph	LANDON, Jean-Joseph	LANDON, Jean-Joseph			
LANGHORNE, John	LANGHORNE, John	LANGHORNE, John	LANGHORNE, John			
LANTEIRES, Jean	LANTEIRES, Jean	LANTEIRES, Jean	LANTEIRES, Jean			
LANTIER, Étienne-François	LANTIER, Étienne-François	LANTIER, Étienne-François	LANTIER, Étienne-François			
LATHOM, Francis	LATHOM, Francis	LATHOM, Francis	LATHOM, Francis			
LAUREAU	LAUREAU	LAUREAU	LAUREAU			
LAUS DE BOISSY, Louis de	LAUS DE BOISSY, Louis de	LAUS DE BOISSY, Louis de	LAUS DE BOISSY, Louis de			
LAVALLEE, Joseph, marquis de	LAVALLEE, Joseph, marquis de	LAVALLEE, Joseph, marquis de	LAVALLEE, Joseph, marquis de			
LAVALLÉE, Joseph, marquis de Bois-Robert	LAVALLÉE, Joseph, marquis de Bois-Robert	LAVALLÉE, Joseph, marquis de Bois-Robert	LAVALLÉE, Joseph, marquis de Bois-Robert			
LAWRENCE, Herbert	LAWRENCE, Herbert	LAWRENCE, Herbert	LAWRENCE, Herbert			
LE BAS, P.-L.	LE BAS, P.-L.	LE BAS, P.-L.	LE BAS, P.-L.			
LE BLANC DE GUILLET, Antoine Blanc, dit	LE BLANC DE GUILLET, Antoine Blanc, dit	LE BLANC DE GUILLET, Antoine Blanc, dit	LE BLANC DE GUILLET, Antoine Blanc, dit			
LE BRETON	LE BRETON	LE BRETON	LE BRETON			
LE CAMUS DE MEZIERES, Nicolas	LE CAMUS DE MEZIERES, Nicolas	LE CAMUS DE MEZIERES, Nicolas	LE CAMUS DE MEZIERES, Nicolas			
LE CAMUS, Antoine	LE CAMUS, Antoine	LE CAMUS, Antoine	LE CAMUS, Antoine			
LE CANUT Raoul, premier duc de	LE CANUT Raoul, premier duc de	LE CANUT Raoul, premier duc de	LE CANUT Raoul, premier duc de			
LE FERON, chevalier	LE FERON, chevalier	LE FERON, chevalier	LE FERON, chevalier			
LE FUEL DE MERICOURT	LE FUEL DE MERICOURT	LE FUEL DE MERICOURT	LE FUEL DE MERICOURT			
LE MONNIER, abbé Guillaume-Antoine	LE MONNIER, abbé Guillaume-Antoine	LE MONNIER, abbé Guillaume-Antoine	LE MONNIER, abbé Guillaume-Antoine			
LE PREVOST D’EXMES, François	LE PREVOST D’EXMES, François	LE PREVOST D’EXMES, François	LE PREVOST D’EXMES, François			
LE TOURNEUR, Pierre-Prime-Félicien	LE TOURNEUR, Pierre-Prime-Félicien	LE TOURNEUR, Pierre-Prime-Félicien	LE TOURNEUR, Pierre-Prime-Félicien			
LE VACHER DE CHARNOIS, Jean-Charles	LE VACHER DE CHARNOIS, Jean-Charles	LE VACHER DE CHARNOIS, Jean-Charles	LE VACHER DE CHARNOIS, Jean-Charles			
LE VACHER DE LA FEUTRIE, madame S.-M.	LE VACHER DE LA FEUTRIE, madame S.-M.	LE VACHER DE LA FEUTRIE, madame S.-M.	LE VACHER DE LA FEUTRIE, madame S.-M.			
LEBAS, P.-L.	LEBAS, P.-L.	LEBAS, P.-L.	LEBAS, P.-L.			
LEBASTIER, C.-B.	LEBASTIER, C.-B.	LEBASTIER, C.-B.	LEBASTIER, C.-B.			
LEBRET, Alexis-Jean	LEBRET, Alexis-Jean	LEBRET, Alexis-Jean	LEBRET, Alexis-Jean			
LEBRUN-TOSSA, Jean-Antoine Brun, dit Alexandrine de	LEBRUN-TOSSA, Jean-Antoine Brun, dit Alexandrine de	LEBRUN-TOSSA, Jean-Antoine Brun, dit Alexandrine de	LEBRUN-TOSSA, Jean-Antoine Brun, dit Alexandrine de			
LECH	LECH	LECH	LECH			
LECLERC, J.-P.-M.	LECLERC, J.-P.-M.	LECLERC, J.-P.-M.	LECLERC, J.-P.-M.			
LECLERC, Jean-Baptiste	LECLERC, Jean-Baptiste	LECLERC, Jean-Baptiste	LECLERC, Jean-Baptiste			
LECLERC, Louis-Claude	LECLERC, Louis-Claude	LECLERC, Louis-Claude	LECLERC, Louis-Claude			
LECLERC, Michel-Théodore	LECLERC, Michel-Théodore	LECLERC, Michel-Théodore	LECLERC, Michel-Théodore			
LECOINTE-MARSILLAC	LECOINTE-MARSILLAC	LECOINTE-MARSILLAC	LECOINTE-MARSILLAC			
LECOMTE	LECOMTE	LECOMTE	LECOMTE			
LECORVAISIER, Pierre-Jean	LECORVAISIER, Pierre-Jean	LECORVAISIER, Pierre-Jean	LECORVAISIER, Pierre-Jean			
LEE, Harriet	LEE, Harriet	LEE, Harriet	LEE, Harriet			
LEE, Margaret	LEE, Margaret	LEE, Margaret	LEE, Margaret			
LEE, Sophia	LEE, Sophia	LEE, Sophia	LEE, Sophia			
LEFEBVRE DE BEAUVRAY, Claude-Rigobert	LEFEBVRE DE BEAUVRAY, Claude-Rigobert	LEFEBVRE DE BEAUVRAY, Claude-Rigobert	LEFEBVRE DE BEAUVRAY, Claude-Rigobert			
LEFEBVRE, Philippe	LEFEBVRE, Philippe	LEFEBVRE, Philippe	LEFEBVRE, Philippe			
LEGOUX DE GERLAN, Bénigne	LEGOUX DE GERLAN, Bénigne	LEGOUX DE GERLAN, Bénigne	LEGOUX DE GERLAN, Bénigne			
LEGRAND DE LA LEU, L.-Auguste	LEGRAND DE LA LEU, L.-Auguste	LEGRAND DE LA LEU, L.-Auguste	LEGRAND DE LA LEU, L.-Auguste			
LEGRAND D’AUSSY, le père Pierre-Jean-Baptiste	LEGRAND D’AUSSY, le père Pierre-Jean-Baptiste	LEGRAND D’AUSSY, le père Pierre-Jean-Baptiste	LEGRAND D’AUSSY, le père Pierre-Jean-Baptiste			
LEGROING-LA-MAISONNEUVE, mademoiselle F.-T.-A.	LEGROING-LA-MAISONNEUVE, mademoiselle F.-T.-A.	LEGROING-LA-MAISONNEUVE, mademoiselle F.-T.-A.	LEGROING-LA-MAISONNEUVE, mademoiselle F.-T.-A.			
LEIGH, sir Samuel Egerton	LEIGH, sir Samuel Egerton	LEIGH, sir Samuel Egerton	LEIGH, sir Samuel Egerton			
LEJEUNE, Augustin	LEJEUNE, Augustin	LEJEUNE, Augustin	LEJEUNE, Augustin			
LEMAIRE	LEMAIRE	LEMAIRE	LEMAIRE			
LEMAIRE, Henri	LEMAIRE, Henri	LEMAIRE, Henri	LEMAIRE, Henri			
LEMIERRE D’ARGY, Auguste-Jacques	LEMIERRE D’ARGY, Auguste-Jacques	LEMIERRE D’ARGY, Auguste-Jacques	LEMIERRE D’ARGY, Auguste-Jacques			
LENNOX, Charlotte Ramsay, Mrs	LENNOX, Charlotte Ramsay, Mrs	LENNOX, Charlotte Ramsay, Mrs	LENNOX, Charlotte Ramsay, Mrs			
LEPREUX, J.-O.	LEPREUX, J.-O.	LEPREUX, J.-O.	LEPREUX, J.-O.			
LEPRINCE DE BEAUMONT, madame Marie	LEPRINCE DE BEAUMONT, madame Marie	LEPRINCE DE BEAUMONT, madame Marie	LEPRINCE DE BEAUMONT, madame Marie			
LERIS, Antoine de	LERIS, Antoine de	LERIS, Antoine de	LERIS, Antoine de			
LEROUX, Adrien	LEROUX, Adrien	LEROUX, Adrien	LEROUX, Adrien			
LEROY DE LOZEMBRUNE, François-Claude	LEROY DE LOZEMBRUNE, François-Claude	LEROY DE LOZEMBRUNE, François-Claude	LEROY DE LOZEMBRUNE, François-Claude			
LESBROS DE LA VERSANE, Louis	LESBROS DE LA VERSANE, Louis	LESBROS DE LA VERSANE, Louis	LESBROS DE LA VERSANE, Louis			
LESCALOPIER DE NOURAR, Charles-Armand	LESCALOPIER DE NOURAR, Charles-Armand	LESCALOPIER DE NOURAR, Charles-Armand	LESCALOPIER DE NOURAR, Charles-Armand			
LESSING, Gotthold Ephraim	LESSING, Gotthold Ephraim	LESSING, Gotthold Ephraim	LESSING, Gotthold Ephraim			
LESUIRE, Robert-Martin	LESUIRE, Robert-Martin	LESUIRE, Robert-Martin	LESUIRE, Robert-Martin			
LEVESQUE, Pierre-Charles	LEVESQUE, Pierre-Charles	LEVESQUE, Pierre-Charles	LEVESQUE, Pierre-Charles			
LEWIS, Matthew Gregory	LEWIS, Matthew Gregory	LEWIS, Matthew Gregory	LEWIS, Matthew Gregory			
LEZAY-MARNÉZIA, Charlotte-Antoinette de Bressay, marquise de	LEZAY-MARNÉZIA, Charlotte-Antoinette de Bressay, marquise de	LEZAY-MARNÉZIA, Charlotte-Antoinette de Bressay, marquise de	LEZAY-MARNÉZIA, Charlotte-Antoinette de Bressay, marquise de			
LEZAY-MARNÉZIA, Claude-François-Adrien, marquis de	LEZAY-MARNÉZIA, Claude-François-Adrien, marquis de	LEZAY-MARNÉZIA, Claude-François-Adrien, marquis de	LEZAY-MARNÉZIA, Claude-François-Adrien, marquis de			
LICHTWEHR, Magnus Gottfried	LICHTWEHR, Magnus Gottfried	LICHTWEHR, Magnus Gottfried	LICHTWEHR, Magnus Gottfried			
LIEBAUT	LIEBAUT	LIEBAUT	LIEBAUT			
LIGNAC, de	LIGNAC, de	LIGNAC, de	LIGNAC, de			
LINGUET, Simon-Nicolas-Henri	LINGUET, Simon-Nicolas-Henri	LINGUET, Simon-Nicolas-Henri	LINGUET, Simon-Nicolas-Henri			
LIOMIN, L.-A.	LIOMIN, L.-A.	LIOMIN, L.-A.	LIOMIN, L.-A.			
LO-LOOZ, Robert, chevalier de	LO-LOOZ, Robert, chevalier de	LO-LOOZ, Robert, chevalier de	LO-LOOZ, Robert, chevalier de			
LOAISEL DE TRÉOGATE, Joseph-Marie	LOAISEL DE TRÉOGATE, Joseph-Marie	LOAISEL DE TRÉOGATE, Joseph-Marie	LOAISEL DE TRÉOGATE, Joseph-Marie			
LOCRÉ, baron Jean-Guillaume	LOCRÉ, baron Jean-Guillaume	LOCRÉ, baron Jean-Guillaume	LOCRÉ, baron Jean-Guillaume			
LOEN, Johann Michael von	LOEN, Johann Michael von	LOEN, Johann Michael von	LOEN, Johann Michael von			
LOMBARD DE LANGRES, Vincent Lombard, dit	LOMBARD DE LANGRES, Vincent Lombard, dit	LOMBARD DE LANGRES, Vincent Lombard, dit	LOMBARD DE LANGRES, Vincent Lombard, dit			
LONGCHAMPS, abbé Pierre Charpentier de	LONGCHAMPS, abbé Pierre Charpentier de	LONGCHAMPS, abbé Pierre Charpentier de	LONGCHAMPS, abbé Pierre Charpentier de			
LONGUS	LONGUS	LONGUS	LONGUS			
LOQMAN	LOQMAN	LOQMAN	LOQMAN			
LOQUET, Marie-Françoise	LOQUET, Marie-Françoise	LOQUET, Marie-Françoise	LOQUET, Marie-Françoise			
LORY DE NARP, madame	LORY DE NARP, madame	LORY DE NARP, madame	LORY DE NARP, madame			
LOS RIOS, Charlotte-Marie	LOS RIOS, Charlotte-Marie	LOS RIOS, Charlotte-Marie	LOS RIOS, Charlotte-Marie			
LOUIS XVIII, le comte de Provence, depuis	LOUIS XVIII, le comte de Provence, depuis	LOUIS XVIII, le comte de Provence, depuis	LOUIS XVIII, le comte de Provence, depuis			
LOUVET DE COUVRAY, Jean-Baptiste	LOUVET DE COUVRAY, Jean-Baptiste	LOUVET DE COUVRAY, Jean-Baptiste	LOUVET DE COUVRAY, Jean-Baptiste			
LUBERT, mademoiselle de	LUBERT, mademoiselle de	LUBERT, mademoiselle de	LUBERT, mademoiselle de			
LUCAIN	LUCAIN	LUCAIN	LUCAIN			
LUCHET, Jean-Pierre-Louis de La Roche du Maine, marquis de	LUCHET, Jean-Pierre-Louis de La Roche du Maine, marquis de	LUCHET, Jean-Pierre-Louis de La Roche du Maine, marquis de	LUCHET, Jean-Pierre-Louis de La Roche du Maine, marquis de			
LUCIEN DE SAMOSATE	LUCIEN DE SAMOSATE	LUCIEN DE SAMOSATE	LUCIEN DE SAMOSATE			
LYTTELTON, George, lord	LYTTELTON, George, lord	LYTTELTON, George, lord	LYTTELTON, George, lord			
LÉONARD, Nicolas-Germain	LÉONARD, Nicolas-Germain	LÉONARD, Nicolas-Germain	LÉONARD, Nicolas-Germain			
LÉPRINCE DE BEAUMONT, madame Marie	LÉPRINCE DE BEAUMONT, madame Marie	LÉPRINCE DE BEAUMONT, madame Marie	LÉPRINCE DE BEAUMONT, madame Marie			
L’AULNAYE, François-Henri-Stanislas de	L’AULNAYE, François-Henri-Stanislas de	L’AULNAYE, François-Henri-Stanislas de	L’AULNAYE, François-Henri-Stanislas de			
L’ISLE, Jean-Baptiste-Nicolas de	L’ISLE, Jean-Baptiste-Nicolas de	L’ISLE, Jean-Baptiste-Nicolas de	L’ISLE, Jean-Baptiste-Nicolas de			
MACKENZIE, Anna Maria	MACKENZIE, Anna Maria	MACKENZIE, Anna Maria	MACKENZIE, Anna Maria			
MACKENZIE, Henry	MACKENZIE, Henry	MACKENZIE, Henry	MACKENZIE, Henry			
MACPHERSON, James	MACPHERSON, James	MACPHERSON, James	MACPHERSON, James			
MAGNY, Jean-Baptiste-Michel	MAGNY, Jean-Baptiste-Michel	MAGNY, Jean-Baptiste-Michel	MAGNY, Jean-Baptiste-Michel			
MAILHOL, Gabriel	MAILHOL, Gabriel	MAILHOL, Gabriel	MAILHOL, Gabriel			
MAILLARD	MAILLARD	MAILLARD	MAILLARD			
MAIMIEUX, Joseph de	MAIMIEUX, Joseph de	MAIMIEUX, Joseph de	MAIMIEUX, Joseph de			
MAINVILLIERS, Genu Soalhat, chevalier de	MAINVILLIERS, Genu Soalhat, chevalier de	MAINVILLIERS, Genu Soalhat, chevalier de	MAINVILLIERS, Genu Soalhat, chevalier de			
MAISTRE, comte Xavier de	MAISTRE, comte Xavier de	MAISTRE, comte Xavier de	MAISTRE, comte Xavier de			
MALARME, Charlotte de Bournon, comtesse de	MALARME, Charlotte de Bournon, comtesse de	MALARME, Charlotte de Bournon, comtesse de	MALARME, Charlotte de Bournon, comtesse de			
MALLET, David Malloch, dit	MALLET, David Malloch, dit	MALLET, David Malloch, dit	MALLET, David Malloch, dit			
MALLET, Jean-Louis	MALLET, Jean-Louis	MALLET, Jean-Louis	MALLET, Jean-Louis			
MALOUET, Pierre-Victor, baron de	MALOUET, Pierre-Victor, baron de	MALOUET, Pierre-Victor, baron de	MALOUET, Pierre-Victor, baron de			
MAMIN	MAMIN	MAMIN	MAMIN			
MANTELLE, Edmé	MANTELLE, Edmé	MANTELLE, Edmé	MANTELLE, Edmé			
MARCHADIER, abbé	MARCHADIER, abbé	MARCHADIER, abbé	MARCHADIER, abbé			
MARCHAND, Jean-Henri	MARCHAND, Jean-Henri	MARCHAND, Jean-Henri	MARCHAND, Jean-Henri			
MARCHANT, François	MARCHANT, François	MARCHANT, François	MARCHANT, François			
MARCILLY, Laurent	MARCILLY, Laurent	MARCILLY, Laurent	MARCILLY, Laurent			
MARESCOT, Michel	MARESCOT, Michel	MARESCOT, Michel	MARESCOT, Michel			
MARIN, le père Michel-Ange	MARIN, le père Michel-Ange	MARIN, le père Michel-Ange	MARIN, le père Michel-Ange			
MARMONTEL, Jean-François	MARMONTEL, Jean-François	MARMONTEL, Jean-François	MARMONTEL, Jean-François			
MARSHALL, Edmund	MARSHALL, Edmund	MARSHALL, Edmund	MARSHALL, Edmund			
MARSOLLIER DES VIVETIÈRES, Benoît-Joseph	MARSOLLIER DES VIVETIÈRES, Benoît-Joseph	MARSOLLIER DES VIVETIÈRES, Benoît-Joseph	MARSOLLIER DES VIVETIÈRES, Benoît-Joseph			
MARTEAU, François-Joseph	MARTEAU, François-Joseph	MARTEAU, François-Joseph	MARTEAU, François-Joseph			
MARTIGNY, comte de	MARTIGNY, comte de	MARTIGNY, comte de	MARTIGNY, comte de			
MARÉCHAL, Pierre-Sylvain	MARÉCHAL, Pierre-Sylvain	MARÉCHAL, Pierre-Sylvain	MARÉCHAL, Pierre-Sylvain			
MASSIAS, baron Nicolas	MASSIAS, baron Nicolas	MASSIAS, baron Nicolas	MASSIAS, baron Nicolas			
MASSON DE PEZAY, Alexandre-Frédéric-Jacques	MASSON DE PEZAY, Alexandre-Frédéric-Jacques	MASSON DE PEZAY, Alexandre-Frédéric-Jacques	MASSON DE PEZAY, Alexandre-Frédéric-Jacques			
MASSON, Charles-François-Philibert	MASSON, Charles-François-Philibert	MASSON, Charles-François-Philibert	MASSON, Charles-François-Philibert			
MATHEY DE MASSILLIAN, L.-Ch.-C.	MATHEY DE MASSILLIAN, L.-Ch.-C.	MATHEY DE MASSILLIAN, L.-Ch.-C.	MATHEY DE MASSILLIAN, L.-Ch.-C.			
MATON DE LA VARENNE, Pierre-Anne-Louis de	MATON DE LA VARENNE, Pierre-Anne-Louis de	MATON DE LA VARENNE, Pierre-Anne-Louis de	MATON DE LA VARENNE, Pierre-Anne-Louis de			
MATON, Alexis	MATON, Alexis	MATON, Alexis	MATON, Alexis			
MAUBERT DE GOUVEST, Jean-Henri	MAUBERT DE GOUVEST, Jean-Henri	MAUBERT DE GOUVEST, Jean-Henri	MAUBERT DE GOUVEST, Jean-Henri			
MAUCOMBLE, Jean-François-Dieudonné	MAUCOMBLE, Jean-François-Dieudonné	MAUCOMBLE, Jean-François-Dieudonné	MAUCOMBLE, Jean-François-Dieudonné			
MAUVILLON, Eléazar de	MAUVILLON, Eléazar de	MAUVILLON, Eléazar de	MAUVILLON, Eléazar de			
MAYDIEU, abbé Jean	MAYDIEU, abbé Jean	MAYDIEU, abbé Jean	MAYDIEU, abbé Jean			
MAYER, Charles-Joseph de	MAYER, Charles-Joseph de	MAYER, Charles-Joseph de	MAYER, Charles-Joseph de			
MAYEUR DE SAINT-PAUL, François-Marie	MAYEUR DE SAINT-PAUL, François-Marie	MAYEUR DE SAINT-PAUL, François-Marie	MAYEUR DE SAINT-PAUL, François-Marie			
MEADES, Ann	MEADES, Ann	MEADES, Ann	MEADES, Ann			
MEISSNER, August Gottlieb	MEISSNER, August Gottlieb	MEISSNER, August Gottlieb	MEISSNER, August Gottlieb			
MEISTER, Jakob Heinrich	MEISTER, Jakob Heinrich	MEISTER, Jakob Heinrich	MEISTER, Jakob Heinrich			
MERAY, chevalier de	MERAY, chevalier de	MERAY, chevalier de	MERAY, chevalier de			
MERCIER DE COMPIÈGNE, Claude-François-Xavier	MERCIER DE COMPIÈGNE, Claude-François-Xavier	MERCIER DE COMPIÈGNE, Claude-François-Xavier	MERCIER DE COMPIÈGNE, Claude-François-Xavier			
MERCIER, abbé	MERCIER, abbé	MERCIER, abbé	MERCIER, abbé			
MERCIER, Louis-Sébastien	MERCIER, Louis-Sébastien	MERCIER, Louis-Sébastien	MERCIER, Louis-Sébastien			
MERTHGHEN	MERTHGHEN	MERTHGHEN	MERTHGHEN			
MEUSNIER DE QUERLON, Anne-Gabriel	MEUSNIER DE QUERLON, Anne-Gabriel	MEUSNIER DE QUERLON, Anne-Gabriel	MEUSNIER DE QUERLON, Anne-Gabriel			
MICHEL (de Saint-Sauveur-le-Vicomte)	MICHEL (de Saint-Sauveur-le-Vicomte)	MICHEL (de Saint-Sauveur-le-Vicomte)	MICHEL (de Saint-Sauveur-le-Vicomte)			
MILCENT, Jean-Baptiste-Gabriel-Marie de	MILCENT, Jean-Baptiste-Gabriel-Marie de	MILCENT, Jean-Baptiste-Gabriel-Marie de	MILCENT, Jean-Baptiste-Gabriel-Marie de			
MILLER, Johann Martin	MILLER, Johann Martin	MILLER, Johann Martin	MILLER, Johann Martin			
MILLON, Charles	MILLON, Charles	MILLON, Charles	MILLON, Charles			
MILLY, mademoiselle de	MILLY, mademoiselle de	MILLY, mademoiselle de	MILLY, mademoiselle de			
MIMAUT, Jean-François	MIMAUT, Jean-François	MIMAUT, Jean-François	MIMAUT, Jean-François			
MIRABEAU, Honoré-Gabriel de Riqueti, comte de	MIRABEAU, Honoré-Gabriel de Riqueti, comte de	MIRABEAU, Honoré-Gabriel de Riqueti, comte de	MIRABEAU, Honoré-Gabriel de Riqueti, comte de			
MIREMONT, Anne d’Aubourg de La Boire, comtesse de	MIREMONT, Anne d’Aubourg de La Boire, comtesse de	MIREMONT, Anne d’Aubourg de La Boire, comtesse de	MIREMONT, Anne d’Aubourg de La Boire, comtesse de			
MOET, Jean-Pierre	MOET, Jean-Pierre	MOET, Jean-Pierre	MOET, Jean-Pierre			
MOISSY, Alexandre-Guillaume Mouslier de	MOISSY, Alexandre-Guillaume Mouslier de	MOISSY, Alexandre-Guillaume Mouslier de	MOISSY, Alexandre-Guillaume Mouslier de			
MOLINE, Pierre-Louis	MOLINE, Pierre-Louis	MOLINE, Pierre-Louis	MOLINE, Pierre-Louis			
MOLIÈRE, J.-L.-J.	MOLIÈRE, J.-L.-J.	MOLIÈRE, J.-L.-J.	MOLIÈRE, J.-L.-J.			
MOLLET, Jean-Louis	MOLLET, Jean-Louis	MOLLET, Jean-Louis	MOLLET, Jean-Louis			
MOLÉ, Guillaume-François-Roger	MOLÉ, Guillaume-François-Roger	MOLÉ, Guillaume-François-Roger	MOLÉ, Guillaume-François-Roger			
MOMORO, Antoine-François	MOMORO, Antoine-François	MOMORO, Antoine-François	MOMORO, Antoine-François			
MONBART, Marie Joséphine de Lescun de	MONBART, Marie Joséphine de Lescun de	MONBART, Marie Joséphine de Lescun de	MONBART, Marie Joséphine de Lescun de			
MONNERON, Marie-Uranie-Rose, madame	MONNERON, Marie-Uranie-Rose, madame	MONNERON, Marie-Uranie-Rose, madame	MONNERON, Marie-Uranie-Rose, madame			
MONNET, Jean	MONNET, Jean	MONNET, Jean	MONNET, Jean			
MONNET, Marie, née Moreau	MONNET, Marie, née Moreau	MONNET, Marie, née Moreau	MONNET, Marie, née Moreau			
MONTALEMBERT, Marie-Joséphine de Comarrieu, marquise de	MONTALEMBERT, Marie-Joséphine de Comarrieu, marquise de	MONTALEMBERT, Marie-Joséphine de Comarrieu, marquise de	MONTALEMBERT, Marie-Joséphine de Comarrieu, marquise de			
MONTESQUIEU, Charles-Louis de	MONTESQUIEU, Charles-Louis de	MONTESQUIEU, Charles-Louis de	MONTESQUIEU, Charles-Louis de			
MONTESSON, Charlotte-Jeanne Béraud de la Haie de Riou, marquise de	MONTESSON, Charlotte-Jeanne Béraud de la Haie de Riou, marquise de	MONTESSON, Charlotte-Jeanne Béraud de la Haie de Riou, marquise de	MONTESSON, Charlotte-Jeanne Béraud de la Haie de Riou, marquise de			
MONTJOIE, Félix-Louis-Christophe	MONTJOIE, Félix-Louis-Christophe	MONTJOIE, Félix-Louis-Christophe	MONTJOIE, Félix-Louis-Christophe			
MONTOLIEU, Elisabeth-Jeanne-Pauline Polier de Bottens, dite	MONTOLIEU, Elisabeth-Jeanne-Pauline Polier de Bottens, dite	MONTOLIEU, Elisabeth-Jeanne-Pauline Polier de Bottens, dite	MONTOLIEU, Elisabeth-Jeanne-Pauline Polier de Bottens, dite			
MOORE, Dr John	MOORE, Dr John	MOORE, Dr John	MOORE, Dr John			
MOORE, George	MOORE, George	MOORE, George	MOORE, George			
MOREAU, Jacob-Nicolas	MOREAU, Jacob-Nicolas	MOREAU, Jacob-Nicolas	MOREAU, Jacob-Nicolas			
MOREL DE VINDÉ, Charles-Gilbert Terray, vicomte de	MOREL DE VINDÉ, Charles-Gilbert Terray, vicomte de	MOREL DE VINDÉ, Charles-Gilbert Terray, vicomte de	MOREL DE VINDÉ, Charles-Gilbert Terray, vicomte de			
MOREL DE VINDÉ, madame Charles-Gilbert de, née Choppin	MOREL DE VINDÉ, madame Charles-Gilbert de, née Choppin	MOREL DE VINDÉ, madame Charles-Gilbert de, née Choppin	MOREL DE VINDÉ, madame Charles-Gilbert de, née Choppin			
MORELLET, abbé André	MORELLET, abbé André	MORELLET, abbé André	MORELLET, abbé André			
MORELLY	MORELLY	MORELLY	MORELLY			
MORTEMART DE BOISSE, Jeanne-Louise-Philippine de Marbet, dame	MORTEMART DE BOISSE, Jeanne-Louise-Philippine de Marbet, dame	MORTEMART DE BOISSE, Jeanne-Louise-Philippine de Marbet, dame	MORTEMART DE BOISSE, Jeanne-Louise-Philippine de Marbet, dame			
MOTTE, mademoiselle	MOTTE, mademoiselle	MOTTE, mademoiselle	MOTTE, mademoiselle			
MOUHY, Charles de Fieux, chevalier de	MOUHY, Charles de Fieux, chevalier de	MOUHY, Charles de Fieux, chevalier de	MOUHY, Charles de Fieux, chevalier de			
MOUTONNET DE CLAIRFONS, Julien-Jacques	MOUTONNET DE CLAIRFONS, Julien-Jacques	MOUTONNET DE CLAIRFONS, Julien-Jacques	MOUTONNET DE CLAIRFONS, Julien-Jacques			
MOYLIN-FLEURY	MOYLIN-FLEURY	MOYLIN-FLEURY	MOYLIN-FLEURY			
MULLER, Johann Gottwerth	MULLER, Johann Gottwerth	MULLER, Johann Gottwerth	MULLER, Johann Gottwerth			
MURAT, Henriette-Julie de Castelnau, comtesse de	MURAT, Henriette-Julie de Castelnau, comtesse de	MURAT, Henriette-Julie de Castelnau, comtesse de	MURAT, Henriette-Julie de Castelnau, comtesse de			
MUSGRAVE, Agnes	MUSGRAVE, Agnes	MUSGRAVE, Agnes	MUSGRAVE, Agnes			
MUSSET, Louis-Alexandre-Marie de, marquis de Cogners	MUSSET, Louis-Alexandre-Marie de, marquis de Cogners	MUSSET, Louis-Alexandre-Marie de, marquis de Cogners	MUSSET, Louis-Alexandre-Marie de, marquis de Cogners			
MUSSET-PATHAY, Victor-Donatien de Musset, dit	MUSSET-PATHAY, Victor-Donatien de Musset, dit	MUSSET-PATHAY, Victor-Donatien de Musset, dit	MUSSET-PATHAY, Victor-Donatien de Musset, dit			
MUSÉE le Grammairien	MUSÉE le Grammairien	MUSÉE le Grammairien	MUSÉE le Grammairien			
MÉHÉGAN, Guillaume-Alexandre, chevalier de	MÉHÉGAN, Guillaume-Alexandre, chevalier de	MÉHÉGAN, Guillaume-Alexandre, chevalier de	MÉHÉGAN, Guillaume-Alexandre, chevalier de			
MÉNARD, Léon	MÉNARD, Léon	MÉNARD, Léon	MÉNARD, Léon			
MÉNARD, madame	MÉNARD, madame	MÉNARD, madame	MÉNARD, madame			
MÉNÉGAULT, A.-P.-F.	MÉNÉGAULT, A.-P.-F.	MÉNÉGAULT, A.-P.-F.	MÉNÉGAULT, A.-P.-F.			
MÉRARD DE SAINT-JUST, Anne-Jeanne-Félicité d’Ormoy, madame	MÉRARD DE SAINT-JUST, Anne-Jeanne-Félicité d’Ormoy, madame	MÉRARD DE SAINT-JUST, Anne-Jeanne-Félicité d’Ormoy, madame	MÉRARD DE SAINT-JUST, Anne-Jeanne-Félicité d’Ormoy, madame			
MÉRARD DE SAINT-JUST, Simon-Pierre	MÉRARD DE SAINT-JUST, Simon-Pierre	MÉRARD DE SAINT-JUST, Simon-Pierre	MÉRARD DE SAINT-JUST, Simon-Pierre			
MÉRÉ, Elisabeth Guénard, madame Brossin de	MÉRÉ, Elisabeth Guénard, madame Brossin de	MÉRÉ, Elisabeth Guénard, madame Brossin de	MÉRÉ, Elisabeth Guénard, madame Brossin de			
NARBONNE-PELET, Raymond-Jacques-Marie, duc de	NARBONNE-PELET, Raymond-Jacques-Marie, duc de	NARBONNE-PELET, Raymond-Jacques-Marie, duc de	NARBONNE-PELET, Raymond-Jacques-Marie, duc de			
NAUBERT, Christiane-Bénédicte-Eugénie	NAUBERT, Christiane-Bénédicte-Eugénie	NAUBERT, Christiane-Bénédicte-Eugénie	NAUBERT, Christiane-Bénédicte-Eugénie			
NAVARRE	NAVARRE	NAVARRE	NAVARRE			
NERCIAT, André-Robert Andréa de	NERCIAT, André-Robert Andréa de	NERCIAT, André-Robert Andréa de	NERCIAT, André-Robert Andréa de			
NESMOND, comtesse de	NESMOND, comtesse de	NESMOND, comtesse de	NESMOND, comtesse de			
NEUFVILLE DE BRUNABOIS-MONTADOR, chevalier Jean-Florent-Joseph de	NEUFVILLE DE BRUNABOIS-MONTADOR, chevalier Jean-Florent-Joseph de	NEUFVILLE DE BRUNABOIS-MONTADOR, chevalier Jean-Florent-Joseph de	NEUFVILLE DE BRUNABOIS-MONTADOR, chevalier Jean-Florent-Joseph de			
NEYER, J.-A.	NEYER, J.-A.	NEYER, J.-A.	NEYER, J.-A.			
NICOLAÏ, Christoph Friedrich	NICOLAÏ, Christoph Friedrich	NICOLAÏ, Christoph Friedrich	NICOLAÏ, Christoph Friedrich			
NIREL, C.-H.	NIREL, C.-H.	NIREL, C.-H.	NIREL, C.-H.			
NOAILLES, Louis, duc d’Ayen, puis de	NOAILLES, Louis, duc d’Ayen, puis de	NOAILLES, Louis, duc d’Ayen, puis de	NOAILLES, Louis, duc d’Ayen, puis de			
NOGARET, François-Félix	NOGARET, François-Félix	NOGARET, François-Félix	NOGARET, François-Félix			
NOLIVOS SAINT-CYR, Paul-Antoine	NOLIVOS SAINT-CYR, Paul-Antoine	NOLIVOS SAINT-CYR, Paul-Antoine	NOLIVOS SAINT-CYR, Paul-Antoine			
NOUGARET, Pierre-Jean-Baptiste	NOUGARET, Pierre-Jean-Baptiste	NOUGARET, Pierre-Jean-Baptiste	NOUGARET, Pierre-Jean-Baptiste			
NOUVEL	NOUVEL	NOUVEL	NOUVEL			
ORMOY, Charlotte Chaumet, madame d’	ORMOY, Charlotte Chaumet, madame d’	ORMOY, Charlotte Chaumet, madame d’	ORMOY, Charlotte Chaumet, madame d’			
ORTUNEZ DE CALAHORRA, Diego	ORTUNEZ DE CALAHORRA, Diego	ORTUNEZ DE CALAHORRA, Diego	ORTUNEZ DE CALAHORRA, Diego			
OVIDE (Publius Ovidius Naso)	OVIDE (Publius Ovidius Naso)	OVIDE (Publius Ovidius Naso)	OVIDE (Publius Ovidius Naso)			
PAGÈS, François-Xavier	PAGÈS, François-Xavier	PAGÈS, François-Xavier	PAGÈS, François-Xavier			
PAHIN-CHAMPLAIN DE LA BLANCHERIE, Mammès-Claude-Catherine	PAHIN-CHAMPLAIN DE LA BLANCHERIE, Mammès-Claude-Catherine	PAHIN-CHAMPLAIN DE LA BLANCHERIE, Mammès-Claude-Catherine	PAHIN-CHAMPLAIN DE LA BLANCHERIE, Mammès-Claude-Catherine			
PAILLET	PAILLET	PAILLET	PAILLET			
PALMER, John	PALMER, John	PALMER, John	PALMER, John			
PALTOCK, Robert	PALTOCK, Robert	PALTOCK, Robert	PALTOCK, Robert			
PARENT, madame	PARENT, madame	PARENT, madame	PARENT, madame			
PAULMY, Antoine-René de Voyer d’Argenson, marquis de	PAULMY, Antoine-René de Voyer d’Argenson, marquis de	PAULMY, Antoine-René de Voyer d’Argenson, marquis de	PAULMY, Antoine-René de Voyer d’Argenson, marquis de			
PAUMERELLE, abbé C.-J. de B. de	PAUMERELLE, abbé C.-J. de B. de	PAUMERELLE, abbé C.-J. de B. de	PAUMERELLE, abbé C.-J. de B. de			
PECHMEJA, Jean de	PECHMEJA, Jean de	PECHMEJA, Jean de	PECHMEJA, Jean de			
PEIGNOT, Étienne-Gabriel	PEIGNOT, Étienne-Gabriel	PEIGNOT, Étienne-Gabriel	PEIGNOT, Étienne-Gabriel			
PERNAY, F.-Daniel	PERNAY, F.-Daniel	PERNAY, F.-Daniel	PERNAY, F.-Daniel			
PERREAU, Jean-André	PERREAU, Jean-André	PERREAU, Jean-André	PERREAU, Jean-André			
PERRIN, Jacques-Antoine-René	PERRIN, Jacques-Antoine-René	PERRIN, Jacques-Antoine-René	PERRIN, Jacques-Antoine-René			
PERRIN, Pierre	PERRIN, Pierre	PERRIN, Pierre	PERRIN, Pierre			
PERTUSIER, Charles	PERTUSIER, Charles	PERTUSIER, Charles	PERTUSIER, Charles			
PESTALOZZI, Johann Heinrich	PESTALOZZI, Johann Heinrich	PESTALOZZI, Johann Heinrich	PESTALOZZI, Johann Heinrich			
PETIGNY DE SAINT-ROMAIN, Marie-Louise-Rose Levesque, madame	PETIGNY DE SAINT-ROMAIN, Marie-Louise-Rose Levesque, madame	PETIGNY DE SAINT-ROMAIN, Marie-Louise-Rose Levesque, madame	PETIGNY DE SAINT-ROMAIN, Marie-Louise-Rose Levesque, madame			
PEZZL, Johann	PEZZL, Johann	PEZZL, Johann	PEZZL, Johann			
PFEIL, Johann Gottlob Benjamin	PFEIL, Johann Gottlob Benjamin	PFEIL, Johann Gottlob Benjamin	PFEIL, Johann Gottlob Benjamin			
PHÈDRE	PHÈDRE	PHÈDRE	PHÈDRE			
PICARDET	PICARDET	PICARDET	PICARDET			
PICQUENARD, J.-B.	PICQUENARD, J.-B.	PICQUENARD, J.-B.	PICQUENARD, J.-B.			
PICQUÉ, Jean-Pierre	PICQUÉ, Jean-Pierre	PICQUÉ, Jean-Pierre	PICQUÉ, Jean-Pierre			
PIGAULT-LEBRUN, Charles-Antoine-Guillaume Pigault de l’Epinay, dit	PIGAULT-LEBRUN, Charles-Antoine-Guillaume Pigault de l’Epinay, dit	PIGAULT-LEBRUN, Charles-Antoine-Guillaume Pigault de l’Epinay, dit	PIGAULT-LEBRUN, Charles-Antoine-Guillaume Pigault de l’Epinay, dit			
PIGNOTTI, Lorenzo	PIGNOTTI, Lorenzo	PIGNOTTI, Lorenzo	PIGNOTTI, Lorenzo			
PILKINGTON, Mary	PILKINGTON, Mary	PILKINGTON, Mary	PILKINGTON, Mary			
PIROUX, Joseph	PIROUX, Joseph	PIROUX, Joseph	PIROUX, Joseph			
PISSOT, Noël-Laurent	PISSOT, Noël-Laurent	PISSOT, Noël-Laurent	PISSOT, Noël-Laurent			
PLISSON, Marie-Prudence	PLISSON, Marie-Prudence	PLISSON, Marie-Prudence	PLISSON, Marie-Prudence			
POCHET, A.	POCHET, A.	POCHET, A.	POCHET, A.			
POINSINET DE SIVRY, Louis	POINSINET DE SIVRY, Louis	POINSINET DE SIVRY, Louis	POINSINET DE SIVRY, Louis			
POLIER DE BOTTENS, Jeanne-Françoise de	POLIER DE BOTTENS, Jeanne-Françoise de	POLIER DE BOTTENS, Jeanne-Françoise de	POLIER DE BOTTENS, Jeanne-Françoise de			
POLLIN, abbé Jean-Baptiste	POLLIN, abbé Jean-Baptiste	POLLIN, abbé Jean-Baptiste	POLLIN, abbé Jean-Baptiste			
PONA, Francesco	PONA, Francesco	PONA, Francesco	PONA, Francesco			
PONCE	PONCE	PONCE	PONCE			
PONCELIN DE LA ROCHE-TILHAC, J.-Ch.	PONCELIN DE LA ROCHE-TILHAC, J.-Ch.	PONCELIN DE LA ROCHE-TILHAC, J.-Ch.	PONCELIN DE LA ROCHE-TILHAC, J.-Ch.			
PONT-WULLYAMOZ, Marie-Louise-Françoise de	PONT-WULLYAMOZ, Marie-Louise-Françoise de	PONT-WULLYAMOZ, Marie-Louise-Françoise de	PONT-WULLYAMOZ, Marie-Louise-Françoise de			
POPE, Alexander	POPE, Alexander	POPE, Alexander	POPE, Alexander			
PORTER, Anna Maria	PORTER, Anna Maria	PORTER, Anna Maria	PORTER, Anna Maria			
POTTER, John	POTTER, John	POTTER, John	POTTER, John			
POUGENS, Marie-Charles-Joseph de	POUGENS, Marie-Charles-Joseph de	POUGENS, Marie-Charles-Joseph de	POUGENS, Marie-Charles-Joseph de			
POULAIN, mademoiselle (de Nogent-sur-Seine)	POULAIN, mademoiselle (de Nogent-sur-Seine)	POULAIN, mademoiselle (de Nogent-sur-Seine)	POULAIN, mademoiselle (de Nogent-sur-Seine)			
PRATT, Samuel Jackson	PRATT, Samuel Jackson	PRATT, Samuel Jackson	PRATT, Samuel Jackson			
PRIOR, Matthew	PRIOR, Matthew	PRIOR, Matthew	PRIOR, Matthew			
PRÉVOST, abbé Antoine-François	PRÉVOST, abbé Antoine-François	PRÉVOST, abbé Antoine-François	PRÉVOST, abbé Antoine-François			
PUGET DE SAINT-PIERRE	PUGET DE SAINT-PIERRE	PUGET DE SAINT-PIERRE	PUGET DE SAINT-PIERRE			
PUISIEUX, Madeleine d’Arsant, madame de	PUISIEUX, Madeleine d’Arsant, madame de	PUISIEUX, Madeleine d’Arsant, madame de	PUISIEUX, Madeleine d’Arsant, madame de			
PUYSÉGUR, François-Jacques de Chastenet, marquis de	PUYSÉGUR, François-Jacques de Chastenet, marquis de	PUYSÉGUR, François-Jacques de Chastenet, marquis de	PUYSÉGUR, François-Jacques de Chastenet, marquis de			
PÉTRONE, Titus Petronius Arbiter	PÉTRONE, Titus Petronius Arbiter	PÉTRONE, Titus Petronius Arbiter	PÉTRONE, Titus Petronius Arbiter			
QUATREMÈRE-DISJONVAL, madame S.-N.	QUATREMÈRE-DISJONVAL, madame S.-N.	QUATREMÈRE-DISJONVAL, madame S.-N.	QUATREMÈRE-DISJONVAL, madame S.-N.			
QUESNÉ, Jacques Salbigoton	QUESNÉ, Jacques Salbigoton	QUESNÉ, Jacques Salbigoton	QUESNÉ, Jacques Salbigoton			
QUEVEDO Y VILLEGAS, Francisco Gomez de	QUEVEDO Y VILLEGAS, Francisco Gomez de	QUEVEDO Y VILLEGAS, Francisco Gomez de	QUEVEDO Y VILLEGAS, Francisco Gomez de			
QUINQUET, Suzanne Gireux, madame Bertrand	QUINQUET, Suzanne Gireux, madame Bertrand	QUINQUET, Suzanne Gireux, madame Bertrand	QUINQUET, Suzanne Gireux, madame Bertrand			
RABAUT DE SAINT-ÉTIENNE, Jean-Paul	RABAUT DE SAINT-ÉTIENNE, Jean-Paul	RABAUT DE SAINT-ÉTIENNE, Jean-Paul	RABAUT DE SAINT-ÉTIENNE, Jean-Paul			
RABELAIS, François	RABELAIS, François	RABELAIS, François	RABELAIS, François			
RABELLEAU	RABELLEAU	RABELLEAU	RABELLEAU			
RADCLIFFE, Ann Ward, Mrs	RADCLIFFE, Ann Ward, Mrs	RADCLIFFE, Ann Ward, Mrs	RADCLIFFE, Ann Ward, Mrs			
RAITHBY, John	RAITHBY, John	RAITHBY, John	RAITHBY, John			
RAIX, M. le baron de	RAIX, M. le baron de	RAIX, M. le baron de	RAIX, M. le baron de			
RAMOND DE CARBONNIÈRES, baron Louis-François-Elisabeth	RAMOND DE CARBONNIÈRES, baron Louis-François-Elisabeth	RAMOND DE CARBONNIÈRES, baron Louis-François-Elisabeth	RAMOND DE CARBONNIÈRES, baron Louis-François-Elisabeth			
RANÇONNET, abbé	RANÇONNET, abbé	RANÇONNET, abbé	RANÇONNET, abbé			
RASPE, Rudolf Erich	RASPE, Rudolf Erich	RASPE, Rudolf Erich	RASPE, Rudolf Erich			
REBOUL	REBOUL	REBOUL	REBOUL			
REEVE, Mrs Clara	REEVE, Mrs Clara	REEVE, Mrs Clara	REEVE, Mrs Clara			
REGLEY, abbé	REGLEY, abbé	REGLEY, abbé	REGLEY, abbé			
REGNAULT-WARIN, Jean-Baptiste-Joseph-Innocent-Philadelphe	REGNAULT-WARIN, Jean-Baptiste-Joseph-Innocent-Philadelphe	REGNAULT-WARIN, Jean-Baptiste-Joseph-Innocent-Philadelphe	REGNAULT-WARIN, Jean-Baptiste-Joseph-Innocent-Philadelphe			
REMER, Julius August	REMER, Julius August	REMER, Julius August	REMER, Julius August			
RENAUD DE LA GRELAIE	RENAUD DE LA GRELAIE	RENAUD DE LA GRELAIE	RENAUD DE LA GRELAIE			
RICARD SAINT-HILAIRE	RICARD SAINT-HILAIRE	RICARD SAINT-HILAIRE	RICARD SAINT-HILAIRE			
RICCOBONI, Marie-Jeanne Laboras de Mézières, madame	RICCOBONI, Marie-Jeanne Laboras de Mézières, madame	RICCOBONI, Marie-Jeanne Laboras de Mézières, madame	RICCOBONI, Marie-Jeanne Laboras de Mézières, madame			
RICHARD, le père Charles-Louis	RICHARD, le père Charles-Louis	RICHARD, le père Charles-Louis	RICHARD, le père Charles-Louis			
RICHARDSON, Samuel	RICHARDSON, Samuel	RICHARDSON, Samuel	RICHARDSON, Samuel			
RICHARDSON, William	RICHARDSON, William	RICHARDSON, William	RICHARDSON, William			
RIDLEY, James	RIDLEY, James	RIDLEY, James	RIDLEY, James			
RIPAULT, Louis-Madeleine	RIPAULT, Louis-Madeleine	RIPAULT, Louis-Madeleine	RIPAULT, Louis-Madeleine			
RIVAROL, Claude-François, chevalier, ensuite comte de	RIVAROL, Claude-François, chevalier, ensuite comte de	RIVAROL, Claude-François, chevalier, ensuite comte de	RIVAROL, Claude-François, chevalier, ensuite comte de			
ROBERT, Louise-Félicité Guinement de Kéralio, madame	ROBERT, Louise-Félicité Guinement de Kéralio, madame	ROBERT, Louise-Félicité Guinement de Kéralio, madame	ROBERT, Louise-Félicité Guinement de Kéralio, madame			
ROBERT, Marie-Anne de Roumier, madame	ROBERT, Marie-Anne de Roumier, madame	ROBERT, Marie-Anne de Roumier, madame	ROBERT, Marie-Anne de Roumier, madame			
ROBINSON, Mary Darby	ROBINSON, Mary Darby	ROBINSON, Mary Darby	ROBINSON, Mary Darby			
ROCHE, Regina Maria	ROCHE, Regina Maria	ROCHE, Regina Maria	ROCHE, Regina Maria			
ROCHEFORT, A.T. de	ROCHEFORT, A.T. de	ROCHEFORT, A.T. de	ROCHEFORT, A.T. de			
ROME, madame de, née Marné de Morville	ROME, madame de, née Marné de Morville	ROME, madame de, née Marné de Morville	ROME, madame de, née Marné de Morville			
RONESSE, Jacques-Hippolyte	RONESSE, Jacques-Hippolyte	RONESSE, Jacques-Hippolyte	RONESSE, Jacques-Hippolyte			
ROSNY, Antoine-Joseph-Nicolas de	ROSNY, Antoine-Joseph-Nicolas de	ROSNY, Antoine-Joseph-Nicolas de	ROSNY, Antoine-Joseph-Nicolas de			
ROSOI, Barnabé Farmian de, dit Durosoi	ROSOI, Barnabé Farmian de, dit Durosoi	ROSOI, Barnabé Farmian de, dit Durosoi	ROSOI, Barnabé Farmian de, dit Durosoi			
ROSS, mistriss	ROSS, mistriss	ROSS, mistriss	ROSS, mistriss			
ROSSEL, l’avocat	ROSSEL, l’avocat	ROSSEL, l’avocat	ROSSEL, l’avocat			
ROUGET DE LISLE, Claude-Joseph	ROUGET DE LISLE, Claude-Joseph	ROUGET DE LISLE, Claude-Joseph	ROUGET DE LISLE, Claude-Joseph			
ROUSSEAU, Jean-Jacques	ROUSSEAU, Jean-Jacques	ROUSSEAU, Jean-Jacques	ROUSSEAU, Jean-Jacques			
ROUSSEAU, Pierre (de Toulouse)	ROUSSEAU, Pierre (de Toulouse)	ROUSSEAU, Pierre (de Toulouse)	ROUSSEAU, Pierre (de Toulouse)			
ROUSSELOT DE SURGY, Jacques-Philibert	ROUSSELOT DE SURGY, Jacques-Philibert	ROUSSELOT DE SURGY, Jacques-Philibert	ROUSSELOT DE SURGY, Jacques-Philibert			
ROY, abbé Jean	ROY, abbé Jean	ROY, abbé Jean	ROY, abbé Jean			
ROZET	ROZET	ROZET	ROZET			
RUMPLER, chanoine François-Louis	RUMPLER, chanoine François-Louis	RUMPLER, chanoine François-Louis	RUMPLER, chanoine François-Louis			
RUTLIDGE, James, dit Jean-Jacques Rutledge	RUTLIDGE, James, dit Jean-Jacques Rutledge	RUTLIDGE, James, dit Jean-Jacques Rutledge	RUTLIDGE, James, dit Jean-Jacques Rutledge			
RÉMY, abbé Joseph-Honoré	RÉMY, abbé Joseph-Honoré	RÉMY, abbé Joseph-Honoré	RÉMY, abbé Joseph-Honoré			
RÉTIF DE LA BRETONNE, Nicolas-Edme	RÉTIF DE LA BRETONNE, Nicolas-Edme	RÉTIF DE LA BRETONNE, Nicolas-Edme	RÉTIF DE LA BRETONNE, Nicolas-Edme			
RÉVÉRONI SAINT-CYR, baron Jacques-Antoine de	RÉVÉRONI SAINT-CYR, baron Jacques-Antoine de	RÉVÉRONI SAINT-CYR, baron Jacques-Antoine de	RÉVÉRONI SAINT-CYR, baron Jacques-Antoine de			
RÉVÉRONI SAINT-CYR, Jacques-Antoine, baron de	RÉVÉRONI SAINT-CYR, Jacques-Antoine, baron de	RÉVÉRONI SAINT-CYR, Jacques-Antoine, baron de	RÉVÉRONI SAINT-CYR, Jacques-Antoine, baron de			
SABATIER, abbé Antoine, dit Sabatier de Castres	SABATIER, abbé Antoine, dit Sabatier de Castres	SABATIER, abbé Antoine, dit Sabatier de Castres	SABATIER, abbé Antoine, dit Sabatier de Castres			
SACY, Claude-Louis-Michel de	SACY, Claude-Louis-Michel de	SACY, Claude-Louis-Michel de	SACY, Claude-Louis-Michel de			
SADE, Donatien-Alphonse-François, marquis de	SADE, Donatien-Alphonse-François, marquis de	SADE, Donatien-Alphonse-François, marquis de	SADE, Donatien-Alphonse-François, marquis de			
SAINT-AUBIN, madame Mézières du Crest, baronne d’Andlau, marquise de	SAINT-AUBIN, madame Mézières du Crest, baronne d’Andlau, marquise de	SAINT-AUBIN, madame Mézières du Crest, baronne d’Andlau, marquise de	SAINT-AUBIN, madame Mézières du Crest, baronne d’Andlau, marquise de			
SAINT-AULAIRE, Yrieix Beaupoil, marquis de	SAINT-AULAIRE, Yrieix Beaupoil, marquis de	SAINT-AULAIRE, Yrieix Beaupoil, marquis de	SAINT-AULAIRE, Yrieix Beaupoil, marquis de			
SAINT-CHAMOND, Claire-Marie Mazarelli, marquise de	SAINT-CHAMOND, Claire-Marie Mazarelli, marquise de	SAINT-CHAMOND, Claire-Marie Mazarelli, marquise de	SAINT-CHAMOND, Claire-Marie Mazarelli, marquise de			
SAINT-CHAMOND, marquis de	SAINT-CHAMOND, marquis de	SAINT-CHAMOND, marquis de	SAINT-CHAMOND, marquis de			
SAINT-FLOUR	SAINT-FLOUR	SAINT-FLOUR	SAINT-FLOUR			
SAINT-GILLES, mademoiselle de	SAINT-GILLES, mademoiselle de	SAINT-GILLES, mademoiselle de	SAINT-GILLES, mademoiselle de			
SAINT-LAMBERT, Jean-François, marquis de	SAINT-LAMBERT, Jean-François, marquis de	SAINT-LAMBERT, Jean-François, marquis de	SAINT-LAMBERT, Jean-François, marquis de			
SAINT-MARCEL, A.-Philippe Tardieu	SAINT-MARCEL, A.-Philippe Tardieu	SAINT-MARCEL, A.-Philippe Tardieu	SAINT-MARCEL, A.-Philippe Tardieu			
SAINT-MARTIN, Louis-Claude	SAINT-MARTIN, Louis-Claude	SAINT-MARTIN, Louis-Claude	SAINT-MARTIN, Louis-Claude			
SAINT-PIERRE, Jacques-Henri	SAINT-PIERRE, Jacques-Henri	SAINT-PIERRE, Jacques-Henri	SAINT-PIERRE, Jacques-Henri			
SAINT-PIERRE, Jacques-Henri Bernardin de	SAINT-PIERRE, Jacques-Henri Bernardin de	SAINT-PIERRE, Jacques-Henri Bernardin de	SAINT-PIERRE, Jacques-Henri Bernardin de			
SAINTE-COLOMBE, Etienne-Guillaume Colombe, dit	SAINTE-COLOMBE, Etienne-Guillaume Colombe, dit	SAINTE-COLOMBE, Etienne-Guillaume Colombe, dit	SAINTE-COLOMBE, Etienne-Guillaume Colombe, dit			
SAINTE-CROIX, de	SAINTE-CROIX, de	SAINTE-CROIX, de	SAINTE-CROIX, de			
SALVERTE, Aglaé	SALVERTE, Aglaé	SALVERTE, Aglaé	SALVERTE, Aglaé			
SALVERTE, Anne-Joseph-Eusèbe Baconnière de	SALVERTE, Anne-Joseph-Eusèbe Baconnière de	SALVERTE, Anne-Joseph-Eusèbe Baconnière de	SALVERTE, Anne-Joseph-Eusèbe Baconnière de			
SANCHAMAU, J.-B.	SANCHAMAU, J.-B.	SANCHAMAU, J.-B.	SANCHAMAU, J.-B.			
SANCY, abbé de	SANCY, abbé de	SANCY, abbé de	SANCY, abbé de			
SANCY, madame de	SANCY, madame de	SANCY, madame de	SANCY, madame de			
SANDRAS DE COURTILZ, Catien de	SANDRAS DE COURTILZ, Catien de	SANDRAS DE COURTILZ, Catien de	SANDRAS DE COURTILZ, Catien de			
SAPT, abbé de	SAPT, abbé de	SAPT, abbé de	SAPT, abbé de			
SARRASIN, Jean-François	SARRASIN, Jean-François	SARRASIN, Jean-François	SARRASIN, Jean-François			
SAURIN, Bernard-Joseph	SAURIN, Bernard-Joseph	SAURIN, Bernard-Joseph	SAURIN, Bernard-Joseph			
SAUTREAU DE MARSY, Claude-Sixte	SAUTREAU DE MARSY, Claude-Sixte	SAUTREAU DE MARSY, Claude-Sixte	SAUTREAU DE MARSY, Claude-Sixte			
SAVARY, Claude	SAVARY, Claude	SAVARY, Claude	SAVARY, Claude			
SAVIN	SAVIN	SAVIN	SAVIN			
SCHEL, Alexandre de	SCHEL, Alexandre de	SCHEL, Alexandre de	SCHEL, Alexandre de			
SCHULZ, Joachim Christoph Friedrich	SCHULZ, Joachim Christoph Friedrich	SCHULZ, Joachim Christoph Friedrich	SCHULZ, Joachim Christoph Friedrich			
SCHÖNAICH, Christoph Otto, Freyherr von	SCHÖNAICH, Christoph Otto, Freyherr von	SCHÖNAICH, Christoph Otto, Freyherr von	SCHÖNAICH, Christoph Otto, Freyherr von			
SCUDERY, Madeleine de	SCUDERY, Madeleine de	SCUDERY, Madeleine de	SCUDERY, Madeleine de			
SEALLY, John	SEALLY, John	SEALLY, John	SEALLY, John			
SELIS, Nicolas-Joseph	SELIS, Nicolas-Joseph	SELIS, Nicolas-Joseph	SELIS, Nicolas-Joseph			
SELLIER DE MORANVILLE	SELLIER DE MORANVILLE	SELLIER DE MORANVILLE	SELLIER DE MORANVILLE			
SENANCOUR, Etienne-Jean-Baptiste-Pierre-Ignace Pivert de	SENANCOUR, Etienne-Jean-Baptiste-Pierre-Ignace Pivert de	SENANCOUR, Etienne-Jean-Baptiste-Pierre-Ignace Pivert de	SENANCOUR, Etienne-Jean-Baptiste-Pierre-Ignace Pivert de			
SENEBIER, Jean	SENEBIER, Jean	SENEBIER, Jean	SENEBIER, Jean			
SERENT, J.-R. Sébastien de	SERENT, J.-R. Sébastien de	SERENT, J.-R. Sébastien de	SERENT, J.-R. Sébastien de			
SERIEYS, Antoine	SERIEYS, Antoine	SERIEYS, Antoine	SERIEYS, Antoine			
SERVIEZ, le général Emmanuel-Gervais Roergas de	SERVIEZ, le général Emmanuel-Gervais Roergas de	SERVIEZ, le général Emmanuel-Gervais Roergas de	SERVIEZ, le général Emmanuel-Gervais Roergas de			
SEWRIN, Charles-Augustin de Bassompierre, dit	SEWRIN, Charles-Augustin de Bassompierre, dit	SEWRIN, Charles-Augustin de Bassompierre, dit	SEWRIN, Charles-Augustin de Bassompierre, dit			
SHERIDAN, Frances Chamberlaine, Mrs Thomas	SHERIDAN, Frances Chamberlaine, Mrs Thomas	SHERIDAN, Frances Chamberlaine, Mrs Thomas	SHERIDAN, Frances Chamberlaine, Mrs Thomas			
SHERIDAN, William	SHERIDAN, William	SHERIDAN, William	SHERIDAN, William			
SICKELMORE, Richard	SICKELMORE, Richard	SICKELMORE, Richard	SICKELMORE, Richard			
SIRET, Pierre-Louis	SIRET, Pierre-Louis	SIRET, Pierre-Louis	SIRET, Pierre-Louis			
SMITH, Charlotte Turner, Mrs	SMITH, Charlotte Turner, Mrs	SMITH, Charlotte Turner, Mrs	SMITH, Charlotte Turner, Mrs			
SMITH, John	SMITH, John	SMITH, John	SMITH, John			
SMOLLETT, Tobias	SMOLLETT, Tobias	SMOLLETT, Tobias	SMOLLETT, Tobias			
SMYTHIES, miss	SMYTHIES, miss	SMYTHIES, miss	SMYTHIES, miss			
SOAVE, Francesco	SOAVE, Francesco	SOAVE, Francesco	SOAVE, Francesco			
SOLLIER, Pierre	SOLLIER, Pierre	SOLLIER, Pierre	SOLLIER, Pierre			
SOUZA, Adélai’de-Marie-Émilie Filleul, comtesse de Flahaut, puis marquise de	SOUZA, Adélai’de-Marie-Émilie Filleul, comtesse de Flahaut, puis marquise de	SOUZA, Adélai’de-Marie-Émilie Filleul, comtesse de Flahaut, puis marquise de	SOUZA, Adélai’de-Marie-Émilie Filleul, comtesse de Flahaut, puis marquise de			
SOUZA, Adélaïde-Marie-Emilie, comtesse de Flahaut, puis marquise de	SOUZA, Adélaïde-Marie-Emilie, comtesse de Flahaut, puis marquise de	SOUZA, Adélaïde-Marie-Emilie, comtesse de Flahaut, puis marquise de	SOUZA, Adélaïde-Marie-Emilie, comtesse de Flahaut, puis marquise de			
SPENCER, lady Caroline	SPENCER, lady Caroline	SPENCER, lady Caroline	SPENCER, lady Caroline			
SPIESS, Christian Heinrich	SPIESS, Christian Heinrich	SPIESS, Christian Heinrich	SPIESS, Christian Heinrich			
SPIESS, Heinrich	SPIESS, Heinrich	SPIESS, Heinrich	SPIESS, Heinrich			
STANISLAS I, roi de Pologne	STANISLAS I, roi de Pologne	STANISLAS I, roi de Pologne	STANISLAS I, roi de Pologne			
STAËL-HOLSTEIN, Anne-Louise-Germaine Necker, baronne de	STAËL-HOLSTEIN, Anne-Louise-Germaine Necker, baronne de	STAËL-HOLSTEIN, Anne-Louise-Germaine Necker, baronne de	STAËL-HOLSTEIN, Anne-Louise-Germaine Necker, baronne de			
STERNE, Laurence	STERNE, Laurence	STERNE, Laurence	STERNE, Laurence			
STETTEN, Paul von	STETTEN, Paul von	STETTEN, Paul von	STETTEN, Paul von			
STEVENS, John	STEVENS, John	STEVENS, John	STEVENS, John			
STICOTTI, Antoine-Fabio	STICOTTI, Antoine-Fabio	STICOTTI, Antoine-Fabio	STICOTTI, Antoine-Fabio			
STURZ, Helferich Peter	STURZ, Helferich Peter	STURZ, Helferich Peter	STURZ, Helferich Peter			
SUREMAIN, Louise-Marie Melchior	SUREMAIN, Louise-Marie Melchior	SUREMAIN, Louise-Marie Melchior	SUREMAIN, Louise-Marie Melchior			
SURR, Thomas Skinner	SURR, Thomas Skinner	SURR, Thomas Skinner	SURR, Thomas Skinner			
SÉGUR, Alexandre-Joseph-Pierre, vicomte de	SÉGUR, Alexandre-Joseph-Pierre, vicomte de	SÉGUR, Alexandre-Joseph-Pierre, vicomte de	SÉGUR, Alexandre-Joseph-Pierre, vicomte de			
SÉLIS, Nicolas-Joseph	SÉLIS, Nicolas-Joseph	SÉLIS, Nicolas-Joseph	SÉLIS, Nicolas-Joseph			
SÉNAC DE MEILHAN, Gabriel	SÉNAC DE MEILHAN, Gabriel	SÉNAC DE MEILHAN, Gabriel	SÉNAC DE MEILHAN, Gabriel			
SÉRIEYS, Antoine	SÉRIEYS, Antoine	SÉRIEYS, Antoine	SÉRIEYS, Antoine			
SÊGUIER DE SAINT-BRISSON	SÊGUIER DE SAINT-BRISSON	SÊGUIER DE SAINT-BRISSON	SÊGUIER DE SAINT-BRISSON			
TACONNET, Toussaint-Gaspard	TACONNET, Toussaint-Gaspard	TACONNET, Toussaint-Gaspard	TACONNET, Toussaint-Gaspard			
TALLEMAND, abbé	TALLEMAND, abbé	TALLEMAND, abbé	TALLEMAND, abbé			
TASSO, Torquato, dit le Tasse	TASSO, Torquato, dit le Tasse	TASSO, Torquato, dit le Tasse	TASSO, Torquato, dit le Tasse			
TASSONI, Alessandro	TASSONI, Alessandro	TASSONI, Alessandro	TASSONI, Alessandro			
TAUPIN D’ORVAL, Jean-Louis-Claude	TAUPIN D’ORVAL, Jean-Louis-Claude	TAUPIN D’ORVAL, Jean-Louis-Claude	TAUPIN D’ORVAL, Jean-Louis-Claude			
TENCIN, Claudine-Alexandrine Guérin, marquise de	TENCIN, Claudine-Alexandrine Guérin, marquise de	TENCIN, Claudine-Alexandrine Guérin, marquise de	TENCIN, Claudine-Alexandrine Guérin, marquise de			
TESSON DE LA GUÉRIE, Jean	TESSON DE LA GUÉRIE, Jean	TESSON DE LA GUÉRIE, Jean	TESSON DE LA GUÉRIE, Jean			
TEUBERN, Hans Ernest von	TEUBERN, Hans Ernest von	TEUBERN, Hans Ernest von	TEUBERN, Hans Ernest von			
TEUTON	TEUTON	TEUTON	TEUTON			
THIARD DE BISSY, comte Henri-Charles de	THIARD DE BISSY, comte Henri-Charles de	THIARD DE BISSY, comte Henri-Charles de	THIARD DE BISSY, comte Henri-Charles de			
THIBOUVILLE, Henri de Lambert d’Herbigny, marquis de	THIBOUVILLE, Henri de Lambert d’Herbigny, marquis de	THIBOUVILLE, Henri de Lambert d’Herbigny, marquis de	THIBOUVILLE, Henri de Lambert d’Herbigny, marquis de			
THIERY	THIERY	THIERY	THIERY			
THIROUX D’ARCONVILLE, Marie-Geneviève-Charlotte Darius, madame	THIROUX D’ARCONVILLE, Marie-Geneviève-Charlotte Darius, madame	THIROUX D’ARCONVILLE, Marie-Geneviève-Charlotte Darius, madame	THIROUX D’ARCONVILLE, Marie-Geneviève-Charlotte Darius, madame			
THOMASSEAU DE CURSAY, abbé Jean-Marie-Joseph Thomasseau, dit	THOMASSEAU DE CURSAY, abbé Jean-Marie-Joseph Thomasseau, dit	THOMASSEAU DE CURSAY, abbé Jean-Marie-Joseph Thomasseau, dit	THOMASSEAU DE CURSAY, abbé Jean-Marie-Joseph Thomasseau, dit			
THOREL DE CAMPIGNEULLES, Charles-Claude-Florent de	THOREL DE CAMPIGNEULLES, Charles-Claude-Florent de	THOREL DE CAMPIGNEULLES, Charles-Claude-Florent de	THOREL DE CAMPIGNEULLES, Charles-Claude-Florent de			
THÉVENEAU DE MORANDE, Charles	THÉVENEAU DE MORANDE, Charles	THÉVENEAU DE MORANDE, Charles	THÉVENEAU DE MORANDE, Charles			
THÜMMEL, Moritz August von	THÜMMEL, Moritz August von	THÜMMEL, Moritz August von	THÜMMEL, Moritz August von			
TIPHAIGNE DE LA ROCHE, Charles-François	TIPHAIGNE DE LA ROCHE, Charles-François	TIPHAIGNE DE LA ROCHE, Charles-François	TIPHAIGNE DE LA ROCHE, Charles-François			
TOMLINS, Elizabeth Sophia	TOMLINS, Elizabeth Sophia	TOMLINS, Elizabeth Sophia	TOMLINS, Elizabeth Sophia			
TOTT, Claire de	TOTT, Claire de	TOTT, Claire de	TOTT, Claire de			
TOURNEMINE, René-Joseph de	TOURNEMINE, René-Joseph de	TOURNEMINE, René-Joseph de	TOURNEMINE, René-Joseph de			
TOURNON, Alexandre, dit	TOURNON, Alexandre, dit	TOURNON, Alexandre, dit	TOURNON, Alexandre, dit			
TOUSSAINT, François-Vincent	TOUSSAINT, François-Vincent	TOUSSAINT, François-Vincent	TOUSSAINT, François-Vincent			
TOUSTAIN-RICHEBOURG, Charles Gaspard de Toustain, vicomte de	TOUSTAIN-RICHEBOURG, Charles Gaspard de Toustain, vicomte de	TOUSTAIN-RICHEBOURG, Charles Gaspard de Toustain, vicomte de	TOUSTAIN-RICHEBOURG, Charles Gaspard de Toustain, vicomte de			
TRENCK, Friedrich, baron de	TRENCK, Friedrich, baron de	TRENCK, Friedrich, baron de	TRENCK, Friedrich, baron de			
TRESSAC DE VERGY, Pierre-Henri	TRESSAC DE VERGY, Pierre-Henri	TRESSAC DE VERGY, Pierre-Henri	TRESSAC DE VERGY, Pierre-Henri			
TRESSAN, abbé Maurice-Elisabeth de Lavergne de	TRESSAN, abbé Maurice-Elisabeth de Lavergne de	TRESSAN, abbé Maurice-Elisabeth de Lavergne de	TRESSAN, abbé Maurice-Elisabeth de Lavergne de			
TRESSAN, Louis-Elisabeth de Lavergne, comte de	TRESSAN, Louis-Elisabeth de Lavergne, comte de	TRESSAN, Louis-Elisabeth de Lavergne, comte de	TRESSAN, Louis-Elisabeth de Lavergne, comte de			
TRIMMER, Sarah	TRIMMER, Sarah	TRIMMER, Sarah	TRIMMER, Sarah			
TSCHUDI, Jean-Baptiste-Louis-Théodore, baron de	TSCHUDI, Jean-Baptiste-Louis-Théodore, baron de	TSCHUDI, Jean-Baptiste-Louis-Théodore, baron de	TSCHUDI, Jean-Baptiste-Louis-Théodore, baron de			
TSCHUDY, Thédore-Henri, baron de	TSCHUDY, Thédore-Henri, baron de	TSCHUDY, Thédore-Henri, baron de	TSCHUDY, Thédore-Henri, baron de			
TURPIN, François-Henri	TURPIN, François-Henri	TURPIN, François-Henri	TURPIN, François-Henri			
ULLOA Y PEREIRA, Luis de	ULLOA Y PEREIRA, Luis de	ULLOA Y PEREIRA, Luis de	ULLOA Y PEREIRA, Luis de			
UNCY, mademoiselle	UNCY, mademoiselle	UNCY, mademoiselle	UNCY, mademoiselle			
USSIEUX, Louis d’	USSIEUX, Louis d’	USSIEUX, Louis d’	USSIEUX, Louis d’			
USSIÈRES, H.	USSIÈRES, H.	USSIÈRES, H.	USSIÈRES, H.			
VAREILLES-SOMMIÈRES, Auguste-Jean-François-Antoine de Labroue, baron de	VAREILLES-SOMMIÈRES, Auguste-Jean-François-Antoine de Labroue, baron de	VAREILLES-SOMMIÈRES, Auguste-Jean-François-Antoine de Labroue, baron de	VAREILLES-SOMMIÈRES, Auguste-Jean-François-Antoine de Labroue, baron de			
VASSE, Cornélie-Pétronille-Bénédicte Wouters, baronne de	VASSE, Cornélie-Pétronille-Bénédicte Wouters, baronne de	VASSE, Cornélie-Pétronille-Bénédicte Wouters, baronne de	VASSE, Cornélie-Pétronille-Bénédicte Wouters, baronne de			
VATTEL, Emerich de	VATTEL, Emerich de	VATTEL, Emerich de	VATTEL, Emerich de			
VERDAN	VERDAN	VERDAN	VERDAN			
VERNES fils, F.	VERNES fils, F.	VERNES fils, F.	VERNES fils, F.			
VERNES, Jacques	VERNES, Jacques	VERNES, Jacques	VERNES, Jacques			
VESQUE DE PUTTELANGE, Jean	VESQUE DE PUTTELANGE, Jean	VESQUE DE PUTTELANGE, Jean	VESQUE DE PUTTELANGE, Jean			
VIDAMPIERRE, la comtesse de	VIDAMPIERRE, la comtesse de	VIDAMPIERRE, la comtesse de	VIDAMPIERRE, la comtesse de			
VIEL, Etienne-René	VIEL, Etienne-René	VIEL, Etienne-René	VIEL, Etienne-René			
VILDÉ, madame L.	VILDÉ, madame L.	VILDÉ, madame L.	VILDÉ, madame L.			
VILLEMAIN D’ABANCOURT, François-Jean	VILLEMAIN D’ABANCOURT, François-Jean	VILLEMAIN D’ABANCOURT, François-Jean	VILLEMAIN D’ABANCOURT, François-Jean			
VILLENEUVE DE LISTONAY	VILLENEUVE DE LISTONAY	VILLENEUVE DE LISTONAY	VILLENEUVE DE LISTONAY			
VILLENEUVE, de	VILLENEUVE, de	VILLENEUVE, de	VILLENEUVE, de			
VILLENEUVE, Gabrielle-Suzanne Barbot de	VILLENEUVE, Gabrielle-Suzanne Barbot de	VILLENEUVE, Gabrielle-Suzanne Barbot de	VILLENEUVE, Gabrielle-Suzanne Barbot de			
VILLETERQUE, Alexandre-Louis	VILLETERQUE, Alexandre-Louis	VILLETERQUE, Alexandre-Louis	VILLETERQUE, Alexandre-Louis			
VILLIERS, P. de	VILLIERS, P. de	VILLIERS, P. de	VILLIERS, P. de			
VINCENT (de Rouen)	VINCENT (de Rouen)	VINCENT (de Rouen)	VINCENT (de Rouen)			
VINCENT, Jean-Louis	VINCENT, Jean-Louis	VINCENT, Jean-Louis	VINCENT, Jean-Louis			
VIOLAINE, madame la comtesse de	VIOLAINE, madame la comtesse de	VIOLAINE, madame la comtesse de	VIOLAINE, madame la comtesse de			
VIRGILE	VIRGILE	VIRGILE	VIRGILE			
VOIART, Jacques-Philippe	VOIART, Jacques-Philippe	VOIART, Jacques-Philippe	VOIART, Jacques-Philippe			
VOISENON, Claude-Henri de Fusée, abbé de	VOISENON, Claude-Henri de Fusée, abbé de	VOISENON, Claude-Henri de Fusée, abbé de	VOISENON, Claude-Henri de Fusée, abbé de			
VOLTAIRE, François-Marie Arouet de	VOLTAIRE, François-Marie Arouet de	VOLTAIRE, François-Marie Arouet de	VOLTAIRE, François-Marie Arouet de			
WALCKANAER	WALCKANAER	WALCKANAER	WALCKANAER			
WALKER, George	WALKER, George	WALKER, George	WALKER, George			
WALKER, lady Mary, née Hamilton	WALKER, lady Mary, née Hamilton	WALKER, lady Mary, née Hamilton	WALKER, lady Mary, née Hamilton			
WALL, Christian Lebrecht Heyne, dit Anton	WALL, Christian Lebrecht Heyne, dit Anton	WALL, Christian Lebrecht Heyne, dit Anton	WALL, Christian Lebrecht Heyne, dit Anton			
WALPOLE, Horace	WALPOLE, Horace	WALPOLE, Horace	WALPOLE, Horace			
WARGEMONT	WARGEMONT	WARGEMONT	WARGEMONT			
WEISSE, Christian Félix	WEISSE, Christian Félix	WEISSE, Christian Félix	WEISSE, Christian Félix			
WERTHES, Friedrich August Clemens	WERTHES, Friedrich August Clemens	WERTHES, Friedrich August Clemens	WERTHES, Friedrich August Clemens			
WEST, Jane	WEST, Jane	WEST, Jane	WEST, Jane			
WEZEL, Johann Karl	WEZEL, Johann Karl	WEZEL, Johann Karl	WEZEL, Johann Karl			
WHITE, J.	WHITE, J.	WHITE, J.	WHITE, J.			
WIELAND, Christoph Martin	WIELAND, Christoph Martin	WIELAND, Christoph Martin	WIELAND, Christoph Martin			
WIESENHUETTEN, Frederike Henriette, baronne de	WIESENHUETTEN, Frederike Henriette, baronne de	WIESENHUETTEN, Frederike Henriette, baronne de	WIESENHUETTEN, Frederike Henriette, baronne de			
WITART DE BEZU	WITART DE BEZU	WITART DE BEZU	WITART DE BEZU			
WOBESER, Wilhelmine Caroline, née von Rebeux	WOBESER, Wilhelmine Caroline, née von Rebeux	WOBESER, Wilhelmine Caroline, née von Rebeux	WOBESER, Wilhelmine Caroline, née von Rebeux			
WOLFF, Elisabeth Bekker, dame	WOLFF, Elisabeth Bekker, dame	WOLFF, Elisabeth Bekker, dame	WOLFF, Elisabeth Bekker, dame			
WOLZOGEN, Friederike Sophie Karoline Auguste von	WOLZOGEN, Friederike Sophie Karoline Auguste von	WOLZOGEN, Friederike Sophie Karoline Auguste von	WOLZOGEN, Friederike Sophie Karoline Auguste von			
WOODFIN, Mrs A.	WOODFIN, Mrs A.	WOODFIN, Mrs A.	WOODFIN, Mrs A.			
WOUTERS, Marie	WOUTERS, Marie	WOUTERS, Marie	WOUTERS, Marie			
WYNNE, Justinienne, comtesse ORSINI-ROSENBERG	WYNNE, Justinienne, comtesse ORSINI-ROSENBERG	WYNNE, Justinienne, comtesse ORSINI-ROSENBERG	WYNNE, Justinienne, comtesse ORSINI-ROSENBERG			
YON, le chevalier	YON, le chevalier	YON, le chevalier	YON, le chevalier			
ZACHARIAE, Friedrich Wilhelm	ZACHARIAE, Friedrich Wilhelm	ZACHARIAE, Friedrich Wilhelm	ZACHARIAE, Friedrich Wilhelm			
ZACHARIE, G.-G.	ZACHARIE, G.-G.	ZACHARIE, G.-G.	ZACHARIE, G.-G.			
ZAYAS Y SOTOMAYOR, Dofia Maria	ZAYAS Y SOTOMAYOR, Dofia Maria	ZAYAS Y SOTOMAYOR, Dofia Maria	ZAYAS Y SOTOMAYOR, Dofia Maria			
ZIEGLER UND KLIPHAUSEN, Heinrich Anselm von	ZIEGLER UND KLIPHAUSEN, Heinrich Anselm von	ZIEGLER UND KLIPHAUSEN, Heinrich Anselm von	ZIEGLER UND KLIPHAUSEN, Heinrich Anselm von			
ÉSOPE DE PHRYGIE	ÉSOPE DE PHRYGIE	ÉSOPE DE PHRYGIE	ÉSOPE DE PHRYGIE			
GALLAND, Antoine	GALLAND, Antoine	GALLAND, Antoine	GALLAND, Antoine			